datetime,Global_active_power,Global_intensity,Sub_metering_1,Sub_metering_2,Sub_metering_3,Temp_Min,Temp_Max,Humidity_Min,Humidity_Max,Temp_Avg,Temp_Range,Humidity_Avg,Humidity_Range
2007-01-01 06:00:00,755.962,3098.6,0,71,0,54,57,77,88,55.5,3,82.5,11
2007-01-01 12:00:00,943.716,3913.2,0,71,871,48,52,76,82,50.0,4,79.0,6
2007-01-01 18:00:00,660.24,2765.6000000000004,0,104,3682,48,52,54,71,50.0,4,62.5,17
2007-01-02 00:00:00,236.048,991.2,0,71,1327,43,46,76,93,44.5,3,84.5,17
2007-01-02 06:00:00,211.768,900.1999999999999,0,104,866,41,45,76,87,43.0,4,81.5,11
2007-01-02 12:00:00,156.614,661.2,0,69,0,39,45,81,87,42.0,6,84.0,6
2007-01-02 18:00:00,381.406,1598.8,0,76,2404,45,46,81,87,45.5,1,84.0,6
2007-01-03 00:00:00,519.448,2188.0,0,99,3292,45,45,81,87,45.0,0,84.0,6
2007-01-03 06:00:00,234.884,995.8,0,69,653,39,45,87,93,42.0,6,90.0,6
2007-01-03 12:00:00,204.526,903.2,0,102,507,39,43,87,93,41.0,4,90.0,6
2007-01-03 18:00:00,291.772,1232.4,0,69,2927,43,46,87,87,44.5,3,87.0,0
2007-01-04 00:00:00,282.872,1208.8,0,104,678,45,46,81,87,45.5,1,84.0,6
2007-01-04 06:00:00,944.184,3913.8,1051,644,0,45,46,87,93,45.5,1,90.0,6
2007-01-04 12:00:00,819.6120000000001,3419.4,0,104,3125,46,52,82,93,49.0,6,87.5,11
2007-01-04 18:00:00,992.114,4180.2,0,6641,5723,48,52,71,82,50.0,4,76.5,11
2007-01-05 00:00:00,503.502,2135.2,0,208,2048,48,50,66,76,49.0,2,71.0,10
2007-01-05 06:00:00,838.182,3450.0,0,115,536,48,48,76,87,48.0,0,81.5,11
2007-01-05 12:00:00,744.74,3110.4,0,74,615,48,48,87,87,48.0,0,87.0,0
2007-01-05 18:00:00,277.714,1206.2,0,111,1411,50,52,82,87,51.0,2,84.5,5
2007-01-06 00:00:00,852.728,3588.0,1483,79,5040,50,52,88,94,51.0,2,91.0,6
2007-01-06 06:00:00,192.694,842.0,0,113,1195,52,52,94,94,52.0,0,94.0,0
2007-01-06 12:00:00,340.322,1468.8,0,78,971,52,54,88,100,53.0,2,94.0,12
2007-01-06 18:00:00,631.312,2725.2,1336,113,3349,54,55,82,88,54.5,1,85.0,6
2007-01-07 00:00:00,344.05,1507.2,0,98,163,46,54,81,94,50.0,8,87.5,13
2007-01-07 06:00:00,149.516,679.4,0,92,589,43,46,81,93,44.5,3,87.0,12
2007-01-07 12:00:00,206.792,923.2,0,525,856,41,45,93,100,43.0,4,96.5,7
2007-01-07 18:00:00,892.372,3769.4,991,4152,5179,46,52,71,87,49.0,6,79.0,16
2007-01-08 00:00:00,1198.94,5115.0,996,3408,6186,48,48,82,93,48.0,0,87.5,11
2007-01-08 06:00:00,475.9980000000001,1960.2,0,140,6183,50,52,82,87,51.0,2,84.5,5
2007-01-08 12:00:00,465.398,1967.0,0,105,3704,50,52,82,94,51.0,2,88.0,12
2007-01-08 18:00:00,523.72,2207.6,0,93,4191,50,52,76,94,51.0,2,85.0,18
2007-01-09 00:00:00,776.244,3299.6,0,129,3469,50,55,88,94,52.5,5,91.0,6
2007-01-09 06:00:00,136.466,611.2,0,83,503,55,55,88,94,55.0,0,91.0,6
2007-01-09 12:00:00,587.902,2464.6,1139,113,5207,54,55,88,94,54.5,1,91.0,6
2007-01-09 18:00:00,299.256,1289.8,0,104,2197,55,57,72,88,56.0,2,80.0,16
2007-01-10 00:00:00,845.43,3584.8,549,3967,1883,52,54,82,88,53.0,2,85.0,6
2007-01-10 06:00:00,143.784,646.8,0,194,563,50,52,82,88,51.0,2,85.0,6
2007-01-10 12:00:00,817.592,3440.6,771,2585,5305,48,50,82,87,49.0,2,84.5,5
2007-01-10 18:00:00,448.746,1910.8,0,1561,1651,52,55,77,88,53.5,3,82.5,11
2007-01-11 00:00:00,744.678,3157.0,0,116,3493,41,50,76,87,45.5,9,81.5,11
2007-01-11 06:00:00,141.602,638.6,0,105,614,39,41,87,93,40.0,2,90.0,6
2007-01-11 12:00:00,590.134,2461.6,841,84,5285,41,45,76,87,43.0,4,81.5,11
2007-01-11 18:00:00,444.948,1905.4,0,436,2317,46,52,76,87,49.0,6,81.5,11
2007-01-12 00:00:00,1078.51,4582.4,537,1545,4199,52,54,82,88,53.0,2,85.0,6
2007-01-12 06:00:00,157.62,704.0,0,147,515,45,50,81,87,47.5,5,84.0,6
2007-01-12 12:00:00,528.884,2209.4,0,92,4479,43,48,87,93,45.5,5,90.0,6
2007-01-12 18:00:00,122.308,563.4,0,91,0,50,54,77,87,52.0,4,82.0,10
2007-01-13 00:00:00,652.484,2728.4,0,109,3282,54,54,82,88,54.0,0,85.0,6
2007-01-13 06:00:00,138.782,623.8,0,71,613,54,54,82,88,54.0,0,85.0,6
2007-01-13 12:00:00,792.74,3377.2,2682,960,2419,50,52,88,94,51.0,2,91.0,6
2007-01-13 18:00:00,729.986,3055.8,978,1858,3464,50,52,82,94,51.0,2,88.0,12
2007-01-14 00:00:00,1525.306,6555.6,4146,86,4845,50,52,82,94,51.0,2,88.0,12
2007-01-14 06:00:00,755.164,3271.4,647,118,1010,48,52,82,94,50.0,4,88.0,12
2007-01-14 12:00:00,540.198,2363.2,0,372,1792,39,48,82,93,43.5,9,87.5,11
2007-01-14 18:00:00,814.36,3457.8,1130,3374,4016,48,54,58,76,51.0,6,67.0,18
2007-01-15 00:00:00,898.094,3813.0,0,351,6157,37,43,87,93,40.0,6,90.0,6
2007-01-15 06:00:00,239.19,997.8,0,76,2329,0,34,93,100,17.0,34,96.5,7
2007-01-15 12:00:00,580.24,2434.0,1099,84,4914,0,37,93,100,18.5,37,96.5,7
2007-01-15 18:00:00,493.488,2079.6,0,88,4774,43,46,81,87,44.5,3,84.0,6
2007-01-16 00:00:00,835.76,3505.2,0,1991,3146,46,46,87,87,46.0,0,87.0,0
2007-01-16 06:00:00,148.872,651.6,0,241,625,43,46,87,93,44.5,3,90.0,6
2007-01-16 12:00:00,371.9,1591.8,1061,89,1318,41,43,87,93,42.0,2,90.0,6
2007-01-16 18:00:00,611.826,2579.8,1002,239,3391,43,48,81,87,45.5,5,84.0,6
2007-01-17 00:00:00,553.806,2342.2,0,75,1249,48,50,82,93,49.0,2,87.5,11
2007-01-17 06:00:00,133.40200000000002,568.4,0,75,563,48,50,93,94,49.0,2,93.5,1
2007-01-17 12:00:00,959.462,4040.2,2410,2445,5396,52,54,82,88,53.0,2,85.0,6
2007-01-17 18:00:00,811.796,3356.4,0,3118,6346,54,55,77,88,54.5,1,82.5,11
2007-01-18 00:00:00,943.028,3963.8,1090,99,3759,52,54,88,94,53.0,2,91.0,6
2007-01-18 06:00:00,220.394,933.4,0,78,1940,52,55,88,94,53.5,3,91.0,6
2007-01-18 12:00:00,449.98,1893.8,0,84,3909,55,57,82,94,56.0,2,88.0,12
2007-01-18 18:00:00,334.944,1436.1999999999998,0,97,2371,57,57,82,88,57.0,0,85.0,6
2007-01-19 00:00:00,816.144,3429.8,0,77,5271,55,59,82,94,57.0,4,88.0,12
2007-01-19 06:00:00,111.164,496.8,0,77,0,55,57,88,94,56.0,2,91.0,6
2007-01-19 12:00:00,540.182,2279.2,1079,76,3839,55,57,82,88,56.0,2,85.0,6
2007-01-19 18:00:00,230.366,995.4,0,96,1300,57,59,77,82,58.0,2,79.5,5
2007-01-20 00:00:00,598.728,2530.4,1024,81,2033,55,57,88,94,56.0,2,91.0,6
2007-01-20 06:00:00,426.838,1907.6,0,76,0,54,55,88,94,54.5,1,91.0,6
2007-01-20 12:00:00,699.5740000000001,3019.6,1485,551,1978,54,55,72,94,54.5,1,83.0,22
2007-01-20 18:00:00,926.818,3910.2,1967,2616,5954,50,57,72,94,53.5,7,83.0,22
2007-01-21 00:00:00,1080.502,4623.8,872,1979,3508,46,50,76,87,48.0,4,81.5,11
2007-01-21 06:00:00,481.132,2136.0,0,103,750,45,46,81,87,45.5,1,84.0,6
2007-01-21 12:00:00,702.696,3013.6,1248,74,3155,43,46,76,87,44.5,3,81.5,11
2007-01-21 18:00:00,793.01,3372.4,3209,1843,3674,46,50,54,76,48.0,4,65.0,22
2007-01-22 00:00:00,1430.424,6152.6,5889,3547,4020,39,45,76,87,42.0,6,81.5,11
2007-01-22 06:00:00,102.794,457.0,0,77,0,37,39,87,93,38.0,2,90.0,6
2007-01-22 12:00:00,696.178,2900.2,1054,85,4953,36,39,87,93,37.5,3,90.0,6
2007-01-22 18:00:00,458.862,1892.4,0,87,4809,41,45,81,87,43.0,4,84.0,6
2007-01-23 00:00:00,922.66,3902.0,0,2734,1599,41,45,81,93,43.0,4,87.0,12
2007-01-23 06:00:00,267.23,1192.4,0,838,642,36,41,44,81,38.5,5,62.5,37
2007-01-23 12:00:00,379.252,1602.8,0,103,2517,32,34,32,51,33.0,2,41.5,19
2007-01-23 18:00:00,207.694,876.4,0,63,544,34,36,20,33,35.0,2,26.5,13
2007-01-24 00:00:00,923.464,3904.0,0,60,1358,32,34,41,75,33.0,2,58.0,34
2007-01-24 06:00:00,557.282,2384.4,0,73,581,32,32,75,87,32.0,0,81.0,12
2007-01-24 12:00:00,982.344,4166.2,1272,2209,4819,34,34,87,93,34.0,0,90.0,6
2007-01-24 18:00:00,794.114,3271.2,2192,125,5204,34,37,81,93,35.5,3,87.0,12
2007-01-25 00:00:00,654.114,2754.6,0,73,1140,30,36,75,87,33.0,6,81.0,12
2007-01-25 06:00:00,119.562,524.0,0,73,281,28,30,86,86,29.0,2,86.0,0
2007-01-25 12:00:00,336.448,1404.8,0,71,2547,27,30,69,86,28.5,3,77.5,17
2007-01-25 18:00:00,409.554,1686.6,104,59,4049,30,32,64,69,31.0,2,66.5,5
2007-01-26 00:00:00,730.78,3050.8,1054,59,4362,28,30,74,75,29.0,2,74.5,1
2007-01-26 06:00:00,100.652,451.4,0,71,0,23,28,74,86,25.5,5,80.0,12
2007-01-26 12:00:00,481.012,2029.2,0,47,2559,23,30,75,93,26.5,7,84.0,18
2007-01-26 18:00:00,383.866,1604.4,0,71,3660,30,37,56,75,33.5,7,65.5,19
2007-01-27 00:00:00,652.442,2713.8,1163,72,2019,36,36,70,81,36.0,0,75.5,11
2007-01-27 06:00:00,123.982,536.6,36,46,0,34,37,81,93,35.5,3,87.0,12
2007-01-27 12:00:00,562.572,2363.8,0,688,3910,34,41,87,93,37.5,7,90.0,6
2007-01-27 18:00:00,705.364,2922.8,1134,1740,6419,43,48,66,87,45.5,5,76.5,21
2007-01-28 00:00:00,652.154,2744.6,0,1422,2045,34,43,76,93,38.5,9,84.5,17
2007-01-28 06:00:00,617.818,2645.8,0,1416,507,0,36,93,100,18.0,36,96.5,7
2007-01-28 12:00:00,669.4839999999999,2866.4,99,83,1761,36,39,93,100,37.5,3,96.5,7
2007-01-28 18:00:00,968.608,4083.4,2316,2406,5824,41,45,71,87,43.0,4,79.0,16
2007-01-29 00:00:00,834.294,3547.8,1051,92,3953,43,43,81,81,43.0,0,81.0,0
2007-01-29 06:00:00,151.15800000000002,645.2,0,74,747,41,43,81,87,42.0,2,84.0,6
2007-01-29 12:00:00,484.352,2036.6,0,73,4360,39,45,81,93,42.0,6,87.0,12
2007-01-29 18:00:00,584.172,2430.4,0,74,6405,48,52,67,82,50.0,4,74.5,15
2007-01-30 00:00:00,762.982,3223.8,1123,73,3742,37,46,81,93,41.5,9,87.0,12
2007-01-30 06:00:00,115.946,513.8,0,73,85,37,45,93,100,41.0,8,96.5,7
2007-01-30 12:00:00,420.504,1781.2,0,63,3066,45,46,87,93,45.5,1,90.0,6
2007-01-30 18:00:00,365.456,1536.6,0,66,2662,46,48,71,87,47.0,2,79.0,16
2007-01-31 00:00:00,805.892,3409.0,1123,1222,2336,45,46,81,93,45.5,1,87.0,12
2007-01-31 06:00:00,158.834,679.2,0,80,533,45,45,87,93,45.0,0,90.0,6
2007-01-31 12:00:00,587.9100000000001,2488.2,0,897,4623,43,45,87,93,44.0,2,90.0,6
2007-01-31 18:00:00,912.988,3823.8,0,4849,6357,46,48,62,76,47.0,2,69.0,14
2007-02-01 00:00:00,704.02,2978.8,0,124,3539,39,46,66,81,42.5,7,73.5,15
2007-02-01 06:00:00,129.634,559.6,0,74,401,43,43,76,93,43.0,0,84.5,17
2007-02-01 12:00:00,808.5260000000001,3387.0,1170,110,6133,43,48,87,93,45.5,5,90.0,6
2007-02-01 18:00:00,159.548,693.4,0,75,314,50,52,82,87,51.0,2,84.5,5
2007-02-02 00:00:00,727.052,3038.8,0,127,6297,50,52,82,87,51.0,2,84.5,5
2007-02-02 06:00:00,134.144,577.6,0,80,467,48,50,87,93,49.0,2,90.0,6
2007-02-02 12:00:00,570.814,2395.6,0,114,5516,48,50,93,100,49.0,2,96.5,7
2007-02-02 18:00:00,248.88,1060.0,0,78,1575,50,50,94,94,50.0,0,94.0,0
2007-02-03 00:00:00,713.898,2980.8,0,84,3780,48,50,87,93,49.0,2,90.0,6
2007-02-03 06:00:00,1054.844,4415.4,0,103,3100,43,48,82,87,45.5,5,84.5,5
2007-02-03 12:00:00,657.802,2772.8,0,244,2499,39,45,66,87,42.0,6,76.5,21
2007-02-03 18:00:00,870.3,3644.0,1215,2077,6092,46,50,54,62,48.0,4,58.0,8
2007-02-04 00:00:00,1446.776,6182.8,3531,2149,6143,39,46,62,87,42.5,7,74.5,25
2007-02-04 06:00:00,1050.608,4480.8,1482,145,2466,37,39,87,93,38.0,2,90.0,6
2007-02-04 12:00:00,806.004,3391.2,0,595,2283,36,43,76,93,39.5,7,84.5,17
2007-02-04 18:00:00,835.7139999999999,3512.2000000000003,1909,2119,6359,45,52,54,76,48.5,7,65.0,22
2007-02-05 00:00:00,903.614,3830.0,0,1738,3364,37,48,66,93,42.5,11,79.5,27
2007-02-05 06:00:00,179.78199999999998,778.4,0,212,774,37,41,81,87,39.0,4,84.0,6
2007-02-05 12:00:00,496.58,2086.4,896,85,3500,41,41,87,93,41.0,0,90.0,6
2007-02-05 18:00:00,341.084,1423.8,0,77,1948,43,43,76,87,43.0,0,81.5,11
2007-02-06 00:00:00,627.834,2652.8,0,2190,1627,39,43,76,93,41.0,4,84.5,17
2007-02-06 06:00:00,143.20600000000002,624.2,0,141,568,39,39,93,93,39.0,0,93.0,0
2007-02-06 12:00:00,370.316,1588.6,1185,86,1121,37,41,87,93,39.0,4,90.0,6
2007-02-06 18:00:00,330.40200000000004,1408.0,0,90,1270,43,45,71,81,44.0,2,76.0,10
2007-02-07 00:00:00,429.556,1810.8,0,88,1558,41,43,76,81,42.0,2,78.5,5
2007-02-07 06:00:00,107.578,479.4,0,113,36,36,39,81,87,37.5,3,84.0,6
2007-02-07 12:00:00,763.058,3190.6,1158,567,6327,32,34,87,100,33.0,2,93.5,13
2007-02-07 18:00:00,671.334,2790.2,1041,2721,3622,36,39,75,93,37.5,3,84.0,18
2007-02-08 00:00:00,786.048,3319.8,1100,112,2001,32,36,81,93,34.0,4,87.0,12
2007-02-08 06:00:00,136.608,592.2,0,89,298,34,34,93,93,34.0,0,93.0,0
2007-02-08 12:00:00,536.038,2227.0,0,87,5322,34,34,93,93,34.0,0,93.0,0
2007-02-08 18:00:00,308.8,1283.2,0,87,2246,34,34,93,93,34.0,0,93.0,0
2007-02-09 00:00:00,819.968,3455.2000000000003,2226,103,2291,34,34,93,93,34.0,0,93.0,0
2007-02-09 06:00:00,108.8,479.6,0,99,0,37,39,87,93,38.0,2,90.0,6
2007-02-09 12:00:00,550.994,2290.2,0,76,5664,37,43,93,93,40.0,6,93.0,0
2007-02-09 18:00:00,287.782,1206.0,0,78,2739,45,50,62,87,47.5,5,74.5,25
2007-02-10 00:00:00,672.622,2831.4,0,2792,1367,46,46,76,87,46.0,0,81.5,11
2007-02-10 06:00:00,125.83,559.2,0,198,0,46,46,87,87,46.0,0,87.0,0
2007-02-10 12:00:00,638.4480000000001,2689.4,1035,1271,2429,46,46,87,87,46.0,0,87.0,0
2007-02-10 18:00:00,702.46,2932.0,893,1261,6371,46,46,87,87,46.0,0,87.0,0
2007-02-11 00:00:00,1362.59,5776.8,3143,101,5605,46,46,87,87,46.0,0,87.0,0
2007-02-11 06:00:00,783.198,3388.6000000000004,0,117,715,48,48,87,93,48.0,0,90.0,6
2007-02-11 12:00:00,947.856,4016.2,0,473,2019,48,50,76,94,49.0,2,85.0,18
2007-02-11 18:00:00,906.122,3819.0,2430,4077,4125,48,54,67,87,51.0,6,77.0,20
2007-02-12 00:00:00,934.052,3934.8,0,98,6255,50,52,67,82,51.0,2,74.5,15
2007-02-12 06:00:00,191.062,832.2,0,93,1222,48,50,87,94,49.0,2,90.5,7
2007-02-12 12:00:00,669.728,2798.4,1158,125,5939,50,52,76,94,51.0,2,85.0,18
2007-02-12 18:00:00,350.4,1475.6,0,96,2864,50,54,58,71,52.0,4,64.5,13
2007-02-13 00:00:00,666.42,2818.8,1069,85,1492,45,50,66,93,47.5,5,79.5,27
2007-02-13 06:00:00,104.682,464.2000000000001,0,78,0,46,46,81,87,46.0,0,84.0,6
2007-02-13 12:00:00,314.608,1321.0,0,116,1205,45,48,76,87,46.5,3,81.5,11
2007-02-13 18:00:00,287.972,1193.6,0,76,1874,48,52,58,71,50.0,4,64.5,13
2007-02-14 00:00:00,707.284,2988.2,0,2558,3177,46,48,66,76,47.0,2,71.0,10
2007-02-14 06:00:00,109.05,487.6,0,170,0,43,48,66,93,45.5,5,79.5,27
2007-02-14 12:00:00,722.5160000000001,3021.4,1138,251,5875,43,48,93,93,45.5,5,93.0,0
2007-02-14 18:00:00,953.696,3974.0,1091,3227,4375,48,52,87,94,50.0,4,90.5,7
2007-02-15 00:00:00,713.41,3050.8,1066,145,1329,45,48,76,87,46.5,3,81.5,11
2007-02-15 06:00:00,171.828,740.8,0,101,712,34,45,76,93,39.5,11,84.5,17
2007-02-15 12:00:00,579.244,2405.2,0,84,5898,34,45,81,100,39.5,11,90.5,19
2007-02-15 18:00:00,240.88,1041.8,0,124,1805,48,50,62,71,49.0,2,66.5,9
2007-02-16 00:00:00,993.394,4193.4,0,2054,5613,43,46,71,81,44.5,3,76.0,10
2007-02-16 06:00:00,269.54200000000003,1189.2,0,66,1466,37,41,81,87,39.0,4,84.0,6
2007-02-16 12:00:00,466.198,1960.0,1148,126,1819,36,43,70,87,39.5,7,78.5,17
2007-02-16 18:00:00,126.442,575.6,0,130,9,45,55,54,71,50.0,10,62.5,17
2007-02-17 00:00:00,840.346,3542.2,0,537,5395,48,54,58,67,51.0,6,62.5,9
2007-02-17 06:00:00,242.252,1023.0,0,127,1902,45,48,57,66,46.5,3,61.5,9
2007-02-17 12:00:00,434.156,1832.0,0,1778,2463,41,52,47,76,46.5,11,61.5,29
2007-02-17 18:00:00,428.526,1853.2,1100,209,1675,55,64,42,52,59.5,9,47.0,10
2007-02-18 00:00:00,971.978,4117.8,665,112,1117,48,55,62,76,51.5,7,69.0,14
2007-02-18 06:00:00,797.41,3334.8,1267,87,1671,45,48,82,87,46.5,3,84.5,5
2007-02-18 12:00:00,1169.384,4891.8,970,519,4177,41,54,67,100,47.5,13,83.5,33
2007-02-18 18:00:00,989.708,4201.4,559,7087,5147,54,61,52,67,57.5,7,59.5,15
2007-02-19 00:00:00,873.26,3756.0,3311,310,2134,43,55,67,93,49.0,12,80.0,26
2007-02-19 06:00:00,150.596,665.6,0,185,505,43,43,93,100,43.0,0,96.5,7
2007-02-19 12:00:00,548.6179999999999,2293.8,0,146,5828,43,45,93,100,44.0,2,96.5,7
2007-02-19 18:00:00,260.698,1107.0,0,115,1820,45,50,76,100,47.5,5,88.0,24
2007-02-20 00:00:00,1226.702,5210.4,1634,2454,4932,43,48,82,93,45.5,5,87.5,11
2007-02-20 06:00:00,912.41,3765.4,0,159,700,39,41,93,100,40.0,2,96.5,7
2007-02-20 12:00:00,1012.764,4238.8,0,130,5288,37,45,87,100,41.0,8,93.5,13
2007-02-20 18:00:00,383.5,1628.4,1084,107,2762,50,57,63,76,53.5,7,69.5,13
2007-02-21 00:00:00,841.2539999999999,3570.0,974,4795,963,50,52,71,82,51.0,2,76.5,11
2007-02-21 06:00:00,147.088,634.2,0,178,632,48,50,82,87,49.0,2,84.5,5
2007-02-21 12:00:00,456.08,1907.4,0,121,4558,48,50,87,93,49.0,2,90.0,6
2007-02-21 18:00:00,428.632,1805.4,357,87,3216,52,55,47,82,53.5,3,64.5,35
2007-02-22 00:00:00,1041.074,4400.2,3170,1946,3142,43,52,54,81,47.5,9,67.5,27
2007-02-22 06:00:00,822.1320000000001,3411.8,120,86,98,39,43,81,93,41.0,4,87.0,12
2007-02-22 12:00:00,939.0,3923.2,0,90,5898,37,46,87,93,41.5,9,90.0,6
2007-02-22 18:00:00,271.384,1132.8,0,84,1028,48,54,67,82,51.0,6,74.5,15
2007-02-23 00:00:00,1336.962,5726.4,1289,3869,5227,48,50,82,87,49.0,2,84.5,5
2007-02-23 06:00:00,149.454,633.4,0,203,676,45,46,87,93,45.5,1,90.0,6
2007-02-23 12:00:00,544.8340000000001,2302.8,0,120,4351,46,52,76,93,49.0,6,84.5,17
2007-02-23 18:00:00,472.638,1948.4,0,72,5759,50,52,76,87,51.0,2,81.5,11
2007-02-24 00:00:00,146.554,624.0,0,108,0,48,52,82,87,50.0,4,84.5,5
2007-02-24 06:00:00,166.232,693.0,0,72,944,48,50,87,93,49.0,2,90.0,6
2007-02-24 12:00:00,312.492,1307.8,0,110,2033,48,52,76,93,50.0,4,84.5,17
2007-02-24 18:00:00,127.918,539.8,0,73,453,52,54,71,82,53.0,2,76.5,11
2007-02-25 00:00:00,108.28,463.0,0,108,132,50,52,71,82,51.0,2,76.5,11
2007-02-25 06:00:00,146.648,608.6,0,72,762,46,52,81,94,49.0,6,87.5,13
2007-02-25 12:00:00,102.26,436.8,0,107,0,43,48,71,81,45.5,5,76.0,10
2007-02-25 18:00:00,153.424,639.6,0,70,898,45,48,71,87,46.5,3,79.0,16
2007-02-26 00:00:00,99.408,420.6,0,80,0,46,48,82,87,47.0,2,84.5,5
2007-02-26 06:00:00,155.546,650.0,0,93,929,45,46,87,93,45.5,1,90.0,6
2007-02-26 12:00:00,128.85399999999998,539.6,0,68,508,46,48,82,93,47.0,2,87.5,11
2007-02-26 18:00:00,128.962,552.8,0,103,446,48,54,54,82,51.0,6,68.0,28
2007-02-27 00:00:00,155.122,646.4,0,67,947,43,50,58,87,46.5,7,72.5,29
2007-02-27 06:00:00,98.846,415.6,0,68,0,41,43,87,93,42.0,2,90.0,6
2007-02-27 12:00:00,158.62,667.8,0,101,954,41,46,87,93,43.5,5,90.0,6
2007-02-27 18:00:00,101.786,447.8,0,69,0,46,55,88,94,50.5,9,91.0,6
2007-02-28 00:00:00,158.86,664.2,0,76,970,52,55,82,94,53.5,3,88.0,12
2007-02-28 06:00:00,102.066,442.6,0,97,0,50,52,87,94,51.0,2,90.5,7
2007-02-28 12:00:00,157.75,652.1999999999999,0,69,986,48,52,82,88,50.0,4,85.0,6
2007-02-28 18:00:00,102.304,437.4,0,103,0,52,57,72,88,54.5,5,80.0,16
2007-03-01 00:00:00,158.654,668.8,0,71,987,50,52,76,87,51.0,2,81.5,11
2007-03-01 06:00:00,154.212,648.5999999999999,0,70,893,50,50,87,87,50.0,0,87.0,0
2007-03-01 12:00:00,104.66,442.2,0,105,77,48,50,76,93,49.0,2,84.5,17
2007-03-01 18:00:00,159.77599999999998,661.0,0,69,1010,50,52,67,71,51.0,2,69.0,4
2007-03-02 00:00:00,98.916,421.0,0,72,0,46,50,71,76,48.0,4,73.5,5
2007-03-02 06:00:00,159.252,669.8,0,100,977,39,45,81,93,42.0,6,87.0,12
2007-03-02 12:00:00,98.87,415.8,0,68,0,39,48,76,93,43.5,9,84.5,17
2007-03-02 18:00:00,158.13,656.6,0,79,992,50,52,67,76,51.0,2,71.5,9
2007-03-03 00:00:00,99.436,427.6,0,93,0,46,54,87,100,50.0,8,93.5,13
2007-03-03 06:00:00,161.5,676.8,0,70,985,52,54,71,94,53.0,2,82.5,23
2007-03-03 12:00:00,104.934,456.8,0,104,0,50,52,67,76,51.0,2,71.5,9
2007-03-03 18:00:00,162.886,688.2,0,70,985,54,55,51,62,54.5,1,56.5,11
2007-03-04 00:00:00,389.802,1635.8,0,103,2627,43,54,58,93,48.5,11,75.5,35
2007-03-04 06:00:00,101.318,426.8,0,71,0,39,45,87,93,42.0,6,90.0,6
2007-03-04 12:00:00,149.87,632.2,0,82,772,39,54,77,100,46.5,15,88.5,23
2007-03-04 18:00:00,685.768,2889.2,885,2995,3989,55,61,59,72,58.0,6,65.5,13
2007-03-05 00:00:00,1153.744,4919.6,591,5563,4647,55,59,59,72,57.0,4,65.5,13
2007-03-05 06:00:00,110.306,486.0,0,174,0,48,55,77,93,51.5,7,85.0,16
2007-03-05 12:00:00,720.552,3021.4,1064,1983,6068,46,52,62,87,49.0,6,74.5,25
2007-03-05 18:00:00,678.4259999999999,2887.4,1195,5728,1629,52,55,47,62,53.5,3,54.5,15
2007-03-06 00:00:00,1151.048,4895.2,3468,4224,2329,48,54,62,76,51.0,6,69.0,14
2007-03-06 06:00:00,101.514,430.4,0,115,0,48,48,71,76,48.0,0,73.5,5
2007-03-06 12:00:00,467.098,1993.0,0,396,2309,48,50,66,76,49.0,2,71.0,10
2007-03-06 18:00:00,182.28,805.4,0,445,566,48,50,82,87,49.0,2,84.5,5
2007-03-07 00:00:00,495.608,2093.0,0,784,1825,48,48,87,87,48.0,0,87.0,0
2007-03-07 06:00:00,124.35,525.6,0,114,277,0,48,0,93,24.0,48,46.5,93
2007-03-07 12:00:00,658.908,2755.4,1076,84,5989,43,50,71,93,46.5,7,82.0,22
2007-03-07 18:00:00,464.088,1924.6,0,712,4759,52,54,54,62,53.0,2,58.0,8
2007-03-08 00:00:00,1127.86,4780.8,0,3851,4488,46,52,58,76,49.0,6,67.0,18
2007-03-08 06:00:00,167.732,722.1999999999999,0,444,682,36,45,76,93,40.5,9,84.5,17
2007-03-08 12:00:00,420.36,1781.0,1073,451,2528,36,50,76,93,43.0,14,84.5,17
2007-03-08 18:00:00,167.462,739.8,0,316,651,54,59,42,62,56.5,5,52.0,20
2007-03-09 00:00:00,816.578,3474.8,1107,2174,2794,43,52,62,87,47.5,9,74.5,25
2007-03-09 06:00:00,104.84,452.8,0,70,0,43,45,81,87,44.0,2,84.0,6
2007-03-09 12:00:00,634.736,2681.8,1093,104,5274,43,46,81,93,44.5,3,87.0,12
2007-03-09 18:00:00,286.688,1207.4,0,103,2675,46,54,47,93,50.0,8,70.0,46
2007-03-10 00:00:00,246.348,1031.0,0,68,682,39,52,50,87,45.5,13,68.5,37
2007-03-10 06:00:00,150.566,648.8,0,100,691,36,45,81,93,40.5,9,87.0,12
2007-03-10 12:00:00,584.5840000000001,2489.2,2676,662,3624,34,50,62,93,42.0,16,77.5,31
2007-03-10 18:00:00,793.048,3380.2,39,4365,4415,52,59,39,62,55.5,7,50.5,23
2007-03-11 00:00:00,956.514,4054.2,1415,295,2249,45,55,51,81,50.0,10,66.0,30
2007-03-11 06:00:00,871.03,3598.0,0,100,0,36,41,87,100,38.5,5,93.5,13
2007-03-11 12:00:00,812.39,3388.2000000000003,0,85,1163,34,52,62,100,43.0,18,81.0,38
2007-03-11 18:00:00,760.52,3227.2,2656,2807,3367,55,59,44,55,57.0,4,49.5,11
2007-03-12 00:00:00,1036.696,4361.6,2154,428,4970,43,55,54,87,49.0,12,70.5,33
2007-03-12 06:00:00,106.112,463.2,0,103,0,36,45,81,93,40.5,9,87.0,12
2007-03-12 12:00:00,652.356,2755.4,1403,81,5467,34,52,67,93,43.0,18,80.0,26
2007-03-12 18:00:00,453.174,1921.6,0,88,2627,55,61,42,54,58.0,6,48.0,12
2007-03-13 00:00:00,739.0260000000001,3108.8,0,2569,4259,43,57,44,81,50.0,14,62.5,37
2007-03-13 06:00:00,108.138,471.4,0,167,0,36,41,81,93,38.5,5,87.0,12
2007-03-13 12:00:00,324.7,1361.6,0,99,2824,36,45,87,93,40.5,9,90.0,6
2007-03-13 18:00:00,148.96,643.2,0,76,668,55,61,34,59,58.0,6,46.5,25
2007-03-14 00:00:00,708.346,3004.0,1350,3517,1831,48,57,59,87,52.5,9,73.0,28
2007-03-14 06:00:00,134.714,599.0,0,200,0,43,48,87,93,45.5,5,90.0,6
2007-03-14 12:00:00,483.94,2016.8,0,109,4982,41,52,76,93,46.5,11,84.5,17
2007-03-14 18:00:00,354.916,1484.8,1099,83,2229,55,59,39,67,57.0,4,53.0,28
2007-03-15 00:00:00,819.794,3484.6,2386,88,1396,45,55,44,71,50.0,10,57.5,27
2007-03-15 06:00:00,153.656,647.4,0,102,541,39,45,70,81,42.0,6,75.5,11
2007-03-15 12:00:00,580.216,2427.4,0,521,5586,39,52,62,81,45.5,13,71.5,19
2007-03-15 18:00:00,347.354,1501.6,0,2495,721,55,59,45,59,57.0,4,52.0,14
2007-03-16 00:00:00,803.588,3377.0,0,145,4188,45,55,54,66,50.0,10,60.0,12
2007-03-16 06:00:00,274.87,1124.0,0,103,0,36,43,70,93,39.5,7,81.5,23
2007-03-16 12:00:00,474.75,2000.4,1106,668,3188,34,45,87,93,39.5,11,90.0,6
2007-03-16 18:00:00,143.422,617.8,0,102,0,50,57,51,71,53.5,7,61.0,20
2007-03-17 00:00:00,809.0120000000001,3446.8,0,3731,2182,43,54,58,87,48.5,11,72.5,29
2007-03-17 06:00:00,115.984,497.8,0,83,0,43,45,87,87,44.0,2,87.0,0
2007-03-17 12:00:00,490.212,2061.4,0,91,3976,45,50,76,87,47.5,5,81.5,11
2007-03-17 18:00:00,611.148,2576.2,2181,104,4533,50,52,76,87,51.0,2,81.5,11
2007-03-18 00:00:00,810.746,3427.0,27,81,3766,50,50,87,87,50.0,0,87.0,0
2007-03-18 06:00:00,122.946,538.2,0,95,0,50,50,82,87,50.0,0,84.5,5
2007-03-18 12:00:00,1020.618,4326.6,3197,5315,2657,46,48,82,93,47.0,2,87.5,11
2007-03-18 18:00:00,323.414,1386.4,1118,168,1070,48,50,54,93,49.0,2,73.5,39
2007-03-19 00:00:00,904.068,3840.2,2249,1791,2129,39,48,50,81,43.5,9,65.5,31
2007-03-19 06:00:00,173.03199999999998,742.8000000000001,560,157,526,37,41,81,87,39.0,4,84.0,6
2007-03-19 12:00:00,572.876,2409.0,0,81,4860,36,41,76,87,38.5,5,81.5,11
2007-03-19 18:00:00,436.794,1812.2,0,102,4394,39,45,61,81,42.0,6,71.0,20
2007-03-20 00:00:00,969.816,4082.0,1088,2346,4338,36,39,75,87,37.5,3,81.0,12
2007-03-20 06:00:00,144.96,610.8000000000001,0,95,665,32,36,81,93,34.0,4,87.0,12
2007-03-20 12:00:00,716.526,3028.6,1099,77,5512,36,39,81,93,37.5,3,87.0,12
2007-03-20 18:00:00,227.492,966.6,0,95,1618,39,46,62,81,42.5,7,71.5,19
2007-03-21 00:00:00,997.25,4251.8,2646,2570,3460,39,41,75,87,40.0,2,81.0,12
2007-03-21 06:00:00,248.454,1036.4,0,165,2321,36,37,81,87,36.5,1,84.0,6
2007-03-21 12:00:00,484.844,2035.0,0,68,4612,36,39,81,87,37.5,3,84.0,6
2007-03-21 18:00:00,571.782,2378.0,1010,1559,3634,39,45,66,87,42.0,6,76.5,21
2007-03-22 00:00:00,837.012,3532.2,855,2341,1768,41,45,57,71,43.0,4,64.0,14
2007-03-22 06:00:00,228.872,954.6,353,488,1336,39,41,65,75,40.0,2,70.0,10
2007-03-22 12:00:00,550.2660000000001,2282.2,0,82,5457,39,41,57,70,40.0,2,63.5,13
2007-03-22 18:00:00,165.786,698.6,0,100,630,43,48,46,53,45.5,5,49.5,7
2007-03-23 00:00:00,510.054,2145.8,0,66,3039,39,46,43,65,42.5,7,54.0,22
2007-03-23 06:00:00,208.27,851.0,0,100,1793,36,39,65,81,37.5,3,73.0,16
2007-03-23 12:00:00,401.118,1666.0,0,66,4128,30,43,76,87,36.5,13,81.5,11
2007-03-23 18:00:00,148.00400000000002,618.8,0,102,103,41,43,87,87,42.0,2,87.0,0
2007-03-24 00:00:00,551.616,2341.6,1127,509,2345,39,41,76,87,40.0,2,81.5,11
2007-03-24 06:00:00,137.148,573.2,0,104,631,37,39,87,87,38.0,2,87.0,0
2007-03-24 12:00:00,534.758,2249.8,0,1426,4046,36,43,81,87,39.5,7,84.0,6
2007-03-24 18:00:00,891.184,3726.6,1266,2415,6365,43,45,81,93,44.0,2,87.0,12
2007-03-25 00:00:00,1405.34,5983.2,2441,1852,5340,43,45,87,93,44.0,2,90.0,6
2007-03-25 06:00:00,858.638,3551.6,0,112,30,43,45,87,93,44.0,2,90.0,6
2007-03-25 12:00:00,810.976,3381.4,0,103,1286,43,46,71,93,44.5,3,82.0,22
2007-03-25 18:00:00,633.548,2670.6,2585,1608,2615,48,50,62,66,49.0,2,64.0,4
2007-03-26 00:00:00,1032.962,4386.8,2045,1777,5427,43,48,62,76,45.5,5,69.0,14
2007-03-26 06:00:00,165.884,716.6,0,104,949,36,41,81,93,38.5,5,87.0,12
2007-03-26 12:00:00,584.906,2458.8,0,67,5327,36,52,67,93,44.0,16,80.0,26
2007-03-26 18:00:00,244.868,1058.4,0,104,1697,54,59,51,63,56.5,5,57.0,12
2007-03-27 00:00:00,420.424,1789.8,1088,69,1123,41,57,55,81,49.0,16,68.0,26
2007-03-27 06:00:00,141.15800000000002,611.8,0,103,608,37,45,81,93,41.0,8,87.0,12
2007-03-27 12:00:00,255.686,1085.0,0,70,1689,37,55,63,93,46.0,18,78.0,30
2007-03-27 18:00:00,144.616,622.6,0,102,637,59,63,39,55,61.0,4,47.0,16
2007-03-28 00:00:00,563.68,2427.6,0,2744,763,48,59,48,76,53.5,11,62.0,28
2007-03-28 06:00:00,146.568,645.8,0,141,642,39,46,76,93,42.5,7,84.5,17
2007-03-28 12:00:00,655.604,2747.4,1122,602,5814,39,59,51,93,49.0,20,72.0,42
2007-03-28 18:00:00,798.398,3338.8,0,5856,5236,59,64,39,52,61.5,5,45.5,13
2007-03-29 00:00:00,733.328,3138.6000000000004,0,1928,2196,50,55,58,71,52.5,5,64.5,13
2007-03-29 06:00:00,150.41,655.6,0,165,583,45,46,81,87,45.5,1,84.0,6
2007-03-29 12:00:00,450.564,1895.2,0,78,4132,45,50,76,87,47.5,5,81.5,11
2007-03-29 18:00:00,132.298,584.4,0,108,229,52,54,58,71,53.0,2,64.5,13
2007-03-30 00:00:00,857.134,3599.4,1162,109,5780,45,52,67,87,48.5,7,77.0,20
2007-03-30 06:00:00,114.32,513.2,0,127,0,39,45,87,93,42.0,6,90.0,6
2007-03-30 12:00:00,545.26,2319.4,0,118,4086,37,39,87,93,38.0,2,90.0,6
2007-03-30 18:00:00,268.972,1152.2,0,122,2010,39,46,62,93,42.5,7,77.5,31
2007-03-31 00:00:00,473.842,2048.2,1094,101,2121,39,45,76,87,42.0,6,81.5,11
2007-03-31 06:00:00,577.77,2421.2,0,77,555,36,37,87,93,36.5,1,90.0,6
2007-03-31 12:00:00,1012.356,4294.599999999999,1507,2497,4532,34,45,76,93,39.5,11,84.5,17
2007-03-31 18:00:00,740.576,3105.6,1102,1197,6331,46,46,71,81,46.0,0,76.0,10
2007-04-01 00:00:00,1178.808,4959.799999999999,11,3936,6264,39,46,81,87,42.5,7,84.0,6
2007-04-01 06:00:00,469.6,1948.2,1087,131,3978,45,46,87,93,45.5,1,90.0,6
2007-04-01 12:00:00,539.14,2260.2,0,95,4553,45,54,67,93,49.5,9,80.0,26
2007-04-01 18:00:00,605.386,2549.0,1841,951,4753,55,61,48,58,58.0,6,53.0,10
2007-04-02 00:00:00,1171.826,4977.8,1701,4224,6225,43,59,59,93,51.0,16,76.0,34
2007-04-02 06:00:00,266.348,1111.2,0,187,2587,46,50,82,87,48.0,4,84.5,5
2007-04-02 12:00:00,523.538,2196.8,0,116,5042,46,61,52,81,53.5,15,66.5,29
2007-04-02 18:00:00,321.696,1340.8,0,106,3486,63,66,43,55,64.5,3,49.0,12
2007-04-03 00:00:00,849.196,3577.4,1755,561,5526,50,64,49,82,57.0,14,65.5,33
2007-04-03 06:00:00,109.508,484.0,0,102,39,46,54,62,76,50.0,8,69.0,14
2007-04-03 12:00:00,553.356,2309.6,0,106,5307,46,54,58,76,50.0,8,67.0,18
2007-04-03 18:00:00,111.17,492.0,0,123,0,54,57,48,58,55.5,3,53.0,10
2007-04-04 00:00:00,868.7860000000001,3693.0,3630,711,2291,45,55,57,71,50.0,10,64.0,14
2007-04-04 06:00:00,107.55,473.4,0,125,0,39,43,76,87,41.0,4,81.5,11
2007-04-04 12:00:00,567.674,2368.2,0,113,5929,39,48,54,81,43.5,9,67.5,27
2007-04-04 18:00:00,626.562,2623.0,2391,66,5311,48,54,41,57,51.0,6,49.0,16
2007-04-05 00:00:00,750.082,3155.6,1043,116,3508,43,52,44,70,47.5,9,57.0,26
2007-04-05 06:00:00,106.108,455.4,0,116,0,39,45,53,65,42.0,6,59.0,12
2007-04-05 12:00:00,605.352,2541.2,0,801,5504,39,52,47,70,45.5,13,58.5,23
2007-04-05 18:00:00,167.454,819.0,0,117,67,55,61,29,47,58.0,6,38.0,18
2007-04-06 00:00:00,965.164,4092.2,1086,3243,4952,46,59,39,58,52.5,13,48.5,19
2007-04-06 06:00:00,180.558,776.4,0,124,955,43,48,76,87,45.5,5,81.5,11
2007-04-06 12:00:00,508.44,2118.4,0,692,4807,43,59,51,87,51.0,16,69.0,36
2007-04-06 18:00:00,187.696,804.8,0,122,1185,61,66,32,48,63.5,5,40.0,16
2007-04-07 00:00:00,724.446,3052.0,0,4528,2219,50,64,40,71,57.0,14,55.5,31
2007-04-07 06:00:00,197.57,836.4,0,186,609,43,52,76,87,47.5,9,81.5,11
2007-04-07 12:00:00,497.852,2107.2,1127,2401,1858,43,52,76,93,47.5,9,84.5,17
2007-04-07 18:00:00,153.708,668.6,0,380,0,57,61,45,59,59.0,4,52.0,14
2007-04-08 00:00:00,704.794,2960.8,0,144,3456,48,57,48,67,52.5,9,57.5,19
2007-04-08 06:00:00,866.294,3586.2,0,118,371,43,46,71,81,44.5,3,76.0,10
2007-04-08 12:00:00,356.056,1549.6,0,119,726,41,54,54,81,47.5,13,67.5,27
2007-04-08 18:00:00,241.51,1041.4,0,122,1796,55,63,39,51,59.0,8,45.0,12
2007-04-09 00:00:00,144.95600000000002,619.4,0,126,652,46,61,39,66,53.5,15,52.5,27
2007-04-09 06:00:00,105.604,460.8,0,120,0,39,43,76,93,41.0,4,84.5,17
2007-04-09 12:00:00,152.158,654.6,0,121,767,39,61,45,93,50.0,22,69.0,48
2007-04-09 18:00:00,276.858,1187.2,1632,137,1067,61,66,32,45,63.5,5,38.5,13
2007-04-10 00:00:00,466.3,1980.8,1035,136,1967,45,64,37,71,54.5,19,54.0,34
2007-04-10 06:00:00,138.108,614.8,0,129,497,45,50,76,93,47.5,5,84.5,17
2007-04-10 12:00:00,112.302,490.2,0,127,93,45,61,52,87,53.0,16,69.5,35
2007-04-10 18:00:00,156.736,676.5999999999999,0,132,739,63,66,32,48,64.5,3,40.0,16
2007-04-11 00:00:00,370.218,1598.6,209,354,1243,54,64,42,67,59.0,10,54.5,25
2007-04-11 06:00:00,242.64,1035.2,0,509,1816,48,52,76,82,50.0,4,79.0,6
2007-04-11 12:00:00,328.606,1387.8,0,326,2950,46,63,59,87,54.5,17,73.0,28
2007-04-11 18:00:00,168.028,716.0,0,141,974,64,68,46,52,66.0,4,49.0,6
2007-04-12 00:00:00,148.208,632.0,0,136,681,52,66,49,76,59.0,14,62.5,27
2007-04-12 06:00:00,106.652,463.0,0,133,0,46,55,67,87,50.5,9,77.0,20
2007-04-12 12:00:00,159.746,681.4,0,133,859,46,63,59,87,54.5,17,73.0,28
2007-04-12 18:00:00,106.216,458.8,0,139,0,68,75,38,49,71.5,7,43.5,11
2007-04-13 00:00:00,165.09199999999998,697.8000000000001,0,136,959,57,72,41,63,64.5,15,52.0,22
2007-04-13 06:00:00,108.054,470.6,0,136,0,54,61,68,82,57.5,7,75.0,14
2007-04-13 12:00:00,165.52,701.6,0,139,975,57,70,52,82,63.5,13,67.0,30
2007-04-13 18:00:00,107.838,472.4,0,140,0,70,75,44,53,72.5,5,48.5,9
2007-04-14 00:00:00,169.61,721.8,0,143,1013,59,73,47,72,66.0,14,59.5,25
2007-04-14 06:00:00,108.358,470.6,0,145,0,54,59,77,88,56.5,5,82.5,11
2007-04-14 12:00:00,167.04199999999997,716.0,0,140,993,52,68,60,88,60.0,16,74.0,28
2007-04-14 18:00:00,107.948,465.6,0,145,0,72,79,44,57,75.5,7,50.5,13
2007-04-15 00:00:00,170.92000000000002,725.8000000000001,0,148,1015,59,77,50,77,68.0,18,63.5,27
2007-04-15 06:00:00,109.744,479.8,0,146,0,54,63,68,94,58.5,9,81.0,26
2007-04-15 12:00:00,139.33,600.0,0,145,511,52,72,60,94,62.0,20,77.0,34
2007-04-15 18:00:00,263.03799999999995,1136.0,0,210,1431,75,81,42,53,78.0,6,47.5,11
2007-04-16 00:00:00,214.052,932.8,0,525,951,64,79,44,73,71.5,15,58.5,29
2007-04-16 06:00:00,76.55799999999999,367.8,0,101,0,64,64,68,68,64.0,0,68.0,0
2007-04-16 12:00:00,191.116,838.4,0,98,1549,64,64,68,68,64.0,0,68.0,0
2007-04-16 18:00:00,189.63,821.5999999999999,0,98,847,64,64,68,68,64.0,0,68.0,0
2007-04-17 00:00:00,495.086,2108.6,952,1008,2260,64,64,68,68,64.0,0,68.0,0
2007-04-17 06:00:00,95.616,468.4,0,97,0,52,59,63,76,55.5,7,69.5,13
2007-04-17 12:00:00,440.19,1859.4,0,98,4701,52,63,63,82,57.5,11,72.5,19
2007-04-17 18:00:00,130.964,608.6,0,97,0,66,68,49,60,67.0,2,54.5,11
2007-04-18 00:00:00,556.9639999999999,2378.4,1532,97,1498,57,66,52,72,61.5,9,62.0,20
2007-04-18 06:00:00,127.344,584.2,0,95,0,46,55,63,81,50.5,9,72.0,18
2007-04-18 12:00:00,382.0,1624.6,935,80,2889,45,55,51,87,50.0,10,69.0,36
2007-04-18 18:00:00,144.914,652.2,644,86,0,59,63,34,42,61.0,4,38.0,8
2007-04-19 00:00:00,343.988,1452.4,0,94,541,52,61,39,63,56.5,9,51.0,24
2007-04-19 06:00:00,198.362,830.0,0,94,605,41,50,62,81,45.5,9,71.5,19
2007-04-19 12:00:00,302.036,1274.4,0,92,3105,39,61,39,87,50.0,22,63.0,48
2007-04-19 18:00:00,220.892,971.2,733,101,1247,63,66,28,39,64.5,3,33.5,11
2007-04-20 00:00:00,307.368,1324.8,0,1318,791,50,66,37,62,58.0,16,49.5,25
2007-04-20 06:00:00,110.438,503.4,0,93,619,46,52,62,76,49.0,6,69.0,14
2007-04-20 12:00:00,192.49,844.0,0,92,1344,45,63,45,81,54.0,18,63.0,36
2007-04-20 18:00:00,144.886,630.6,0,81,588,64,68,37,42,66.0,4,39.5,5
2007-04-21 00:00:00,374.766,1614.6,1069,94,948,52,66,40,59,59.0,14,49.5,19
2007-04-21 06:00:00,91.902,427.0,0,73,392,46,54,58,71,50.0,8,64.5,13
2007-04-21 12:00:00,269.032,1173.8000000000002,608,130,1627,46,59,48,71,52.5,13,59.5,23
2007-04-21 18:00:00,500.656,2118.8,1672,135,4712,59,70,27,48,64.5,11,37.5,21
2007-04-22 00:00:00,812.066,3531.8,4295,125,4398,55,68,37,58,61.5,13,47.5,21
2007-04-22 06:00:00,102.014,501.4,0,113,0,41,52,54,87,46.5,11,70.5,33
2007-04-22 12:00:00,946.328,4030.6,2936,943,3538,39,68,37,93,53.5,29,65.0,56
2007-04-22 18:00:00,512.88,2215.8,1328,589,3485,72,75,29,38,73.5,3,33.5,9
2007-04-23 00:00:00,672.4920000000001,2883.6,0,642,4079,55,75,38,56,65.0,20,47.0,18
2007-04-23 06:00:00,164.406,795.2,0,125,484,52,61,59,82,56.5,9,70.5,23
2007-04-23 12:00:00,468.364,2034.8,1402,115,4045,48,72,50,87,60.0,24,68.5,37
2007-04-23 18:00:00,125.76,573.2,0,155,605,73,79,34,50,76.0,6,42.0,16
2007-04-24 00:00:00,296.036,1297.2,0,111,871,63,79,42,64,71.0,16,53.0,22
2007-04-24 06:00:00,126.73,580.8,0,120,604,54,61,77,88,57.5,7,82.5,11
2007-04-24 12:00:00,278.432,1224.8,0,148,2198,54,72,43,88,63.0,18,65.5,45
2007-04-24 18:00:00,136.434,617.8,0,108,410,75,79,36,44,77.0,4,40.0,8
2007-04-25 00:00:00,490.504,2105.2000000000003,1125,151,3468,63,77,41,68,70.0,14,54.5,27
2007-04-25 06:00:00,108.752,502.2,0,114,604,55,64,59,77,59.5,9,68.0,18
2007-04-25 12:00:00,483.528,2081.0,0,492,4445,54,77,36,82,65.5,23,59.0,46
2007-04-25 18:00:00,170.426,781.4,0,476,978,81,82,26,45,81.5,1,35.5,19
2007-04-26 00:00:00,501.456,2191.0,0,387,2785,63,77,47,68,70.0,14,57.5,21
2007-04-26 06:00:00,74.032,368.0,0,171,0,55,57,72,77,56.0,2,74.5,5
2007-04-26 12:00:00,537.812,2367.4,996,1332,3812,55,68,56,77,61.5,13,66.5,21
2007-04-26 18:00:00,159.458,762.4,0,201,613,72,77,47,53,74.5,5,50.0,6
2007-04-27 00:00:00,504.164,2152.4,328,141,2738,64,77,47,77,70.5,13,62.0,30
2007-04-27 06:00:00,108.762,492.2,0,116,653,57,64,77,88,60.5,7,82.5,11
2007-04-27 12:00:00,208.176,926.8,0,167,1398,55,73,47,94,64.0,18,70.5,47
2007-04-27 18:00:00,145.05,626.2,0,112,117,75,81,32,47,78.0,6,39.5,15
2007-04-28 00:00:00,632.3439999999999,2724.8,1772,150,2588,64,77,36,78,70.5,13,57.0,42
2007-04-28 06:00:00,22.738,97.4,0,18,0,55,61,82,94,58.0,6,88.0,12
2007-04-28 12:00:00,0.0,0.0,0,0,0,57,73,53,88,65.0,16,70.5,35
2007-04-28 18:00:00,0.0,0.0,0,0,0,77,81,32,44,79.0,4,38.0,12
2007-04-29 00:00:00,0.0,0.0,0,0,0,66,77,38,60,71.5,11,49.0,22
2007-04-29 06:00:00,0.0,0.0,0,0,0,55,61,72,88,58.0,6,80.0,16
2007-04-29 12:00:00,0.0,0.0,0,0,0,55,72,60,88,63.5,17,74.0,28
2007-04-29 18:00:00,0.0,0.0,0,0,0,66,75,44,64,70.5,9,54.0,20
2007-04-30 00:00:00,0.0,0.0,0,0,0,59,63,68,88,61.0,4,78.0,20
2007-04-30 06:00:00,0.0,0.0,0,0,0,52,55,88,94,53.5,3,91.0,6
2007-04-30 12:00:00,0.0,0.0,0,0,0,54,68,68,94,61.0,14,81.0,26
2007-04-30 18:00:00,82.438,364.6,0,106,503,70,73,44,64,71.5,3,54.0,20
2007-05-01 00:00:00,338.384,1501.2,1214,394,628,57,72,46,88,64.5,15,67.0,42
2007-05-01 06:00:00,92.422,431.0,0,139,116,52,61,42,58,56.5,9,50.0,16
2007-05-01 12:00:00,427.126,1849.6,0,156,3558,54,64,52,55,59.0,10,53.5,3
2007-05-01 18:00:00,366.084,1610.2,2112,115,889,68,73,29,52,70.5,5,40.5,23
2007-05-02 00:00:00,778.226,3414.8,1893,585,3983,63,72,31,48,67.5,9,39.5,17
2007-05-02 06:00:00,142.32,707.0,0,173,0,54,61,45,54,57.5,7,49.5,9
2007-05-02 12:00:00,306.87,1343.8,0,145,2534,52,64,42,54,58.0,12,48.0,12
2007-05-02 18:00:00,159.66,732.6,0,476,592,66,70,35,40,68.0,4,37.5,5
2007-05-03 00:00:00,394.636,1740.4,7,696,628,59,68,37,72,63.5,9,54.5,35
2007-05-03 06:00:00,263.23,1160.4,997,1293,667,46,57,67,93,51.5,11,80.0,26
2007-05-03 12:00:00,261.086,1138.0,0,141,2451,46,64,56,93,55.0,18,74.5,37
2007-05-03 18:00:00,87.27799999999999,423.6,0,170,0,66,70,35,52,68.0,4,43.5,17
2007-05-04 00:00:00,478.644,2041.0,909,121,4718,59,68,35,72,63.5,9,53.5,37
2007-05-04 06:00:00,70.42,343.4,0,123,0,50,55,72,87,52.5,5,79.5,15
2007-05-04 12:00:00,228.25,1006.4,0,162,1896,52,61,67,88,56.5,9,77.5,21
2007-05-04 18:00:00,134.146,619.8000000000001,0,115,618,63,68,46,64,65.5,5,55.0,18
2007-05-05 00:00:00,565.312,2462.8,2259,138,1476,54,63,55,88,58.5,9,71.5,33
2007-05-05 06:00:00,99.526,474.0,464,144,0,50,54,82,88,52.0,4,85.0,6
2007-05-05 12:00:00,333.87,1448.2,0,529,2950,50,54,77,87,52.0,4,82.0,10
2007-05-05 18:00:00,518.318,2251.4,1264,1658,3200,54,61,67,77,57.5,7,72.0,10
2007-05-06 00:00:00,611.338,2646.4,1185,162,5153,55,61,63,88,58.0,6,75.5,25
2007-05-06 06:00:00,311.67,1427.4,0,118,779,45,50,82,87,47.5,5,84.5,5
2007-05-06 12:00:00,537.302,2358.4,0,137,898,45,57,63,93,51.0,12,78.0,30
2007-05-06 18:00:00,424.358,1842.6,1381,246,2610,61,68,49,59,64.5,7,54.0,10
2007-05-07 00:00:00,828.774,3600.6,1834,448,5808,52,63,63,82,57.5,11,72.5,19
2007-05-07 06:00:00,123.724,553.4,0,112,845,55,55,82,88,55.0,0,85.0,6
2007-05-07 12:00:00,701.56,3071.8,946,3867,3646,55,59,82,88,57.0,4,85.0,6
2007-05-07 18:00:00,332.66,1458.4,0,431,2712,63,66,64,77,64.5,3,70.5,13
2007-05-08 00:00:00,485.72,2089.0,0,525,2230,55,64,68,88,59.5,9,78.0,20
2007-05-08 06:00:00,201.536,864.0,0,132,243,55,59,82,88,57.0,4,85.0,6
2007-05-08 12:00:00,310.04999999999995,1332.6,663,150,2449,55,63,82,94,59.0,8,88.0,12
2007-05-08 18:00:00,732.614,3178.4,2963,1591,4245,63,70,49,82,66.5,7,65.5,33
2007-05-09 00:00:00,545.092,2338.2,955,138,1840,59,66,52,88,62.5,7,70.0,36
2007-05-09 06:00:00,71.428,345.6,0,111,0,59,59,88,88,59.0,0,88.0,0
2007-05-09 12:00:00,472.386,2038.2,0,295,5043,59,59,88,88,59.0,0,88.0,0
2007-05-09 18:00:00,395.052,1762.0,0,5048,0,59,59,88,88,59.0,0,88.0,0
2007-05-10 00:00:00,726.87,3135.0,3018,177,4431,59,59,88,88,59.0,0,88.0,0
2007-05-10 06:00:00,109.88,501.2,0,133,641,54,59,77,88,56.5,5,82.5,11
2007-05-10 12:00:00,156.09,696.0,0,115,953,54,63,63,88,58.5,9,75.5,25
2007-05-10 18:00:00,114.218,526.6,0,147,664,66,75,41,60,70.5,9,50.5,19
2007-05-11 00:00:00,327.696,1454.0,946,139,1003,61,72,50,72,66.5,11,61.0,22
2007-05-11 06:00:00,107.75,496.0,0,112,648,57,59,63,77,58.0,2,70.0,14
2007-05-11 12:00:00,312.95,1398.8,0,139,2588,54,59,55,72,56.5,5,63.5,17
2007-05-11 18:00:00,205.484,943.2,0,129,1540,61,64,48,52,62.5,3,50.0,4
2007-05-12 00:00:00,352.97,1521.8,926,111,1695,57,61,59,94,59.0,4,76.5,35
2007-05-12 06:00:00,89.562,415.6,0,151,105,54,57,82,88,55.5,3,85.0,6
2007-05-12 12:00:00,338.028,1470.2,0,107,3441,54,63,63,88,58.5,9,75.5,25
2007-05-12 18:00:00,489.196,2129.6,934,681,3847,64,68,49,56,66.0,4,52.5,7
2007-05-13 00:00:00,524.78,2263.8,1313,136,3015,57,66,52,88,61.5,9,70.0,36
2007-05-13 06:00:00,144.844,655.6,0,131,595,50,55,77,94,52.5,5,85.5,17
2007-05-13 12:00:00,229.118,1030.2,0,496,532,54,64,68,94,59.0,10,81.0,26
2007-05-13 18:00:00,814.292,3537.0,3446,1684,5265,63,75,43,77,69.0,12,60.0,34
2007-05-14 00:00:00,446.484,1932.8,166,103,2566,57,64,45,72,60.5,7,58.5,27
2007-05-14 06:00:00,131.576,602.0,0,101,511,55,57,67,72,56.0,2,69.5,5
2007-05-14 12:00:00,358.888,1602.6,0,99,2945,55,61,59,77,58.0,6,68.0,18
2007-05-14 18:00:00,169.562,857.6,178,100,0,54,64,52,94,59.0,10,73.0,42
2007-05-15 00:00:00,807.756,3524.6,2998,2117,2061,52,57,67,94,54.5,5,80.5,27
2007-05-15 06:00:00,122.96,547.0,0,114,0,46,50,82,93,48.0,4,87.5,11
2007-05-15 12:00:00,388.034,1667.6,0,96,3876,48,59,59,93,53.5,11,76.0,34
2007-05-15 18:00:00,126.454,560.4,0,98,0,54,63,48,82,58.5,9,65.0,34
2007-05-16 00:00:00,266.944,1161.0,0,100,1442,52,55,77,88,53.5,3,82.5,11
2007-05-16 06:00:00,118.092,497.6,0,97,276,52,54,82,100,53.0,2,91.0,18
2007-05-16 12:00:00,600.024,2563.0,1006,546,5420,54,57,82,94,55.5,3,88.0,12
2007-05-16 18:00:00,492.868,2161.0,0,3408,2028,59,64,48,77,61.5,5,62.5,29
2007-05-17 00:00:00,481.96,2081.8,1207,1705,1353,52,59,63,94,55.5,7,78.5,31
2007-05-17 06:00:00,107.098,484.2,0,102,0,54,55,94,94,54.5,1,94.0,0
2007-05-17 12:00:00,332.766,1450.0,0,1692,1578,55,61,88,94,58.0,6,91.0,6
2007-05-17 18:00:00,260.338,1132.0,1014,177,700,61,64,77,88,62.5,3,82.5,11
2007-05-18 00:00:00,531.614,2292.0,0,102,5409,54,63,82,94,58.5,9,88.0,12
2007-05-18 06:00:00,127.886,546.8,0,101,2,59,59,94,94,59.0,0,94.0,0
2007-05-18 12:00:00,364.432,1542.4,0,101,3766,59,70,68,94,64.5,11,81.0,26
2007-05-18 18:00:00,393.622,1683.6,913,1575,2038,68,75,57,88,71.5,7,72.5,31
2007-05-19 00:00:00,745.59,3249.6,2357,2136,2310,61,68,83,94,64.5,7,88.5,11
2007-05-19 06:00:00,108.618,479.2,0,110,0,57,64,77,88,60.5,7,82.5,11
2007-05-19 12:00:00,410.516,1797.6,1359,150,1615,57,63,68,82,60.0,6,75.0,14
2007-05-19 18:00:00,608.694,2659.8,3324,144,3310,64,68,56,68,66.0,4,62.0,12
2007-05-20 00:00:00,301.61400000000003,1283.2,0,126,2097,63,66,55,88,64.5,3,71.5,33
2007-05-20 06:00:00,128.942,559.2,0,105,328,55,57,54,63,56.0,2,58.5,9
2007-05-20 12:00:00,416.296,1840.0,925,124,590,50,55,67,88,52.5,5,77.5,21
2007-05-20 18:00:00,400.732,1727.8,0,1307,1462,57,59,82,94,58.0,2,88.0,12
2007-05-21 00:00:00,1022.358,4428.8,4495,197,5231,55,59,67,94,57.0,4,80.5,27
2007-05-21 06:00:00,154.44,658.0,0,154,636,55,55,94,94,55.0,0,94.0,0
2007-05-21 12:00:00,432.234,1857.8,0,105,4478,55,63,88,94,59.0,8,91.0,6
2007-05-21 18:00:00,114.454,504.4,0,104,122,66,77,53,83,71.5,11,68.0,30
2007-05-22 00:00:00,418.934,1787.4,0,105,3824,55,75,50,94,65.0,20,72.0,44
2007-05-22 06:00:00,139.082,590.2,0,123,600,54,59,88,94,56.5,5,91.0,6
2007-05-22 12:00:00,344.38,1503.4,931,117,2099,57,68,68,94,62.5,11,81.0,26
2007-05-22 18:00:00,102.474,434.0,0,105,0,68,73,57,68,70.5,5,62.5,11
2007-05-23 00:00:00,546.916,2368.2,0,3621,1285,59,72,60,88,65.5,13,74.0,28
2007-05-23 06:00:00,109.508,478.0,0,220,0,57,61,82,88,59.0,4,85.0,6
2007-05-23 12:00:00,569.192,2451.0,934,122,5441,57,66,73,88,61.5,9,80.5,15
2007-05-23 18:00:00,352.398,1533.4,0,3308,426,68,72,60,68,70.0,4,64.0,8
2007-05-24 00:00:00,433.838,1870.0,22,142,2252,61,70,60,82,65.5,9,71.0,22
2007-05-24 06:00:00,105.032,447.0,0,109,0,57,59,82,88,58.0,2,85.0,6
2007-05-24 12:00:00,396.616,1708.2,955,104,3346,57,73,60,88,65.0,16,74.0,28
2007-05-24 18:00:00,107.71,472.4,0,112,0,77,81,47,50,79.0,4,48.5,3
2007-05-25 00:00:00,545.03,2357.8,0,3791,1400,63,77,50,77,70.0,14,63.5,27
2007-05-25 06:00:00,148.284,631.4,0,206,610,59,64,77,88,61.5,5,82.5,11
2007-05-25 12:00:00,451.774,1943.6,887,154,3984,63,77,54,82,70.0,14,68.0,28
2007-05-25 18:00:00,115.812,514.4,0,114,49,64,84,45,77,74.0,20,61.0,32
2007-05-26 00:00:00,898.35,3914.0,7173,112,1896,61,66,78,94,63.5,5,86.0,16
2007-05-26 06:00:00,144.924,638.4,0,135,598,55,59,94,94,57.0,4,94.0,0
2007-05-26 12:00:00,292.116,1280.2,0,1520,871,59,68,73,100,63.5,9,86.5,27
2007-05-26 18:00:00,531.926,2306.0,1207,978,3581,68,70,68,73,69.0,2,70.5,5
2007-05-27 00:00:00,543.282,2345.8,1166,121,3578,59,66,73,94,62.5,7,83.5,21
2007-05-27 06:00:00,121.698,528.8,0,107,0,48,55,82,88,51.5,7,85.0,6
2007-05-27 12:00:00,286.202,1290.2,0,534,671,48,57,63,87,52.5,9,75.0,24
2007-05-27 18:00:00,1060.632,4603.6,3212,4334,5515,54,55,72,94,54.5,1,83.0,22
2007-05-28 00:00:00,685.276,2946.8,1154,559,4258,50,59,76,94,54.5,9,85.0,18
2007-05-28 06:00:00,166.264,721.2,0,165,644,48,50,87,93,49.0,2,90.0,6
2007-05-28 12:00:00,311.1,1351.2,0,106,2863,48,55,77,94,51.5,7,85.5,17
2007-05-28 18:00:00,441.198,1913.2,1689,103,2538,52,61,63,88,56.5,9,75.5,25
2007-05-29 00:00:00,718.906,3102.0,2865,99,3541,48,54,87,93,51.0,6,90.0,6
2007-05-29 06:00:00,144.594,615.0,0,109,572,45,46,81,87,45.5,1,84.0,6
2007-05-29 12:00:00,388.456,1695.0,0,111,2139,45,57,55,93,51.0,12,74.0,38
2007-05-29 18:00:00,162.99200000000002,723.8,0,103,569,57,63,37,51,60.0,6,44.0,14
2007-05-30 00:00:00,365.298,1584.6,0,1584,1052,48,63,42,87,55.5,15,64.5,45
2007-05-30 06:00:00,99.882,420.4,0,98,0,45,48,81,87,46.5,3,84.0,6
2007-05-30 12:00:00,551.264,2359.8,949,97,5630,50,57,82,88,53.5,7,85.0,6
2007-05-30 18:00:00,446.498,1939.0,0,3431,1966,57,61,82,88,59.0,4,85.0,6
2007-05-31 00:00:00,512.222,2233.8,1301,2322,208,50,57,71,88,53.5,7,79.5,17
2007-05-31 06:00:00,138.494,580.4,0,102,643,48,55,87,94,51.5,7,90.5,7
2007-05-31 12:00:00,211.12,906.0,0,117,1214,48,59,72,100,53.5,11,86.0,28
2007-05-31 18:00:00,116.196,496.0,0,116,244,61,66,52,72,63.5,5,62.0,20
2007-06-01 00:00:00,472.74,2037.8,935,142,1451,54,55,88,94,54.5,1,91.0,6
2007-06-01 06:00:00,112.436,488.4,0,146,0,46,52,93,94,49.0,6,93.5,1
2007-06-01 12:00:00,508.748,2175.6,0,101,5728,48,63,59,94,55.5,15,76.5,35
2007-06-01 18:00:00,163.71,715.6,0,118,863,63,66,49,59,64.5,3,54.0,10
2007-06-02 00:00:00,260.024,1132.6,0,118,1073,54,61,68,94,57.5,7,81.0,26
2007-06-02 06:00:00,162.344,697.8,0,99,747,54,57,82,88,55.5,3,85.0,6
2007-06-02 12:00:00,418.402,1818.4,955,546,884,54,66,68,88,60.0,12,78.0,20
2007-06-02 18:00:00,482.102,2093.0,1164,457,3662,68,75,44,68,71.5,7,56.0,24
2007-06-03 00:00:00,421.514,1833.4,1852,148,2340,57,73,47,82,65.0,16,64.5,35
2007-06-03 06:00:00,166.968,718.2,0,105,686,57,63,77,88,60.0,6,82.5,11
2007-06-03 12:00:00,451.446,1976.6,1627,925,2324,59,73,57,82,66.0,14,69.5,25
2007-06-03 18:00:00,692.038,3005.2,2552,2345,4043,73,75,50,57,74.0,2,53.5,7
2007-06-04 00:00:00,797.574,3448.2,806,4154,1281,64,72,57,77,68.0,8,67.0,20
2007-06-04 06:00:00,143.062,632.6,0,336,510,64,64,77,77,64.0,0,77.0,0
2007-06-04 12:00:00,351.056,1520.2,0,140,3345,64,64,77,77,64.0,0,77.0,0
2007-06-04 18:00:00,100.926,450.0,0,192,0,64,64,77,77,64.0,0,77.0,0
2007-06-05 00:00:00,316.574,1461.2,1585,168,678,64,64,77,77,64.0,0,77.0,0
2007-06-05 06:00:00,190.892,822.6,2,176,969,59,64,77,88,61.5,5,82.5,11
2007-06-05 12:00:00,456.846,2013.2,1834,410,2898,59,72,64,88,65.5,13,76.0,24
2007-06-05 18:00:00,238.996,1094.4,958,231,558,73,75,57,65,74.0,2,61.0,8
2007-06-06 00:00:00,572.158,2499.6000000000004,1690,210,2023,64,73,57,78,68.5,9,67.5,21
2007-06-06 06:00:00,241.252,1035.8,463,137,1895,59,64,82,88,61.5,5,85.0,6
2007-06-06 12:00:00,540.24,2346.0,0,159,5180,61,73,61,88,67.0,12,74.5,27
2007-06-06 18:00:00,282.636,1249.2,942,384,756,75,79,42,61,77.0,4,51.5,19
2007-06-07 00:00:00,629.51,2720.6,1924,149,3832,64,75,50,83,69.5,11,66.5,33
2007-06-07 06:00:00,96.068,433.4,0,157,0,59,63,82,88,61.0,4,85.0,6
2007-06-07 12:00:00,302.474,1315.2,0,190,2531,59,64,82,94,61.5,5,88.0,12
2007-06-07 18:00:00,208.628,902.8,0,202,0,66,72,73,78,69.0,6,75.5,5
2007-06-08 00:00:00,377.832,1643.2,985,150,1428,63,73,73,83,68.0,10,78.0,10
2007-06-08 06:00:00,96.056,427.8,0,154,0,63,68,83,94,65.5,5,88.5,11
2007-06-08 12:00:00,610.9100000000001,2667.0,0,3307,4301,63,68,83,94,65.5,5,88.5,11
2007-06-08 18:00:00,743.098,3221.6000000000004,376,6013,3564,68,73,69,83,70.5,5,76.0,14
2007-06-09 00:00:00,697.982,2969.0,2423,1966,3515,70,72,78,83,71.0,2,80.5,5
2007-06-09 06:00:00,148.94,638.4,0,138,559,63,66,83,88,64.5,3,85.5,5
2007-06-09 12:00:00,263.996,1154.0,852,165,942,63,68,78,88,65.5,5,83.0,10
2007-06-09 18:00:00,235.49,1038.6,0,129,789,70,75,57,73,72.5,5,65.0,16
2007-06-10 00:00:00,411.388,1734.2,0,164,4300,66,75,53,88,70.5,9,70.5,35
2007-06-10 06:00:00,154.89,673.4000000000001,0,101,626,59,64,88,94,61.5,5,91.0,6
2007-06-10 12:00:00,323.304,1412.8,878,1051,1888,59,70,68,100,64.5,11,84.0,32
2007-06-10 18:00:00,547.17,2313.4,3324,414,2382,72,77,54,69,74.5,5,61.5,15
2007-06-11 00:00:00,315.448,1368.6,0,358,1087,66,75,61,78,70.5,9,69.5,17
2007-06-11 06:00:00,91.988,416.8,0,133,0,61,63,88,94,62.0,2,91.0,6
2007-06-11 12:00:00,407.196,1711.2,0,100,4659,63,73,61,94,68.0,10,77.5,33
2007-06-11 18:00:00,74.98,360.8,0,129,0,75,77,50,61,76.0,2,55.5,11
2007-06-12 00:00:00,220.49,993.0,0,125,669,64,72,73,88,68.0,8,80.5,15
2007-06-12 06:00:00,112.244,493.0,0,107,733,61,64,94,94,62.5,3,94.0,0
2007-06-12 12:00:00,188.32,890.6,0,138,767,61,64,73,88,62.5,3,80.5,15
2007-06-12 18:00:00,137.296,631.4,0,129,716,66,73,60,73,69.5,7,66.5,13
2007-06-13 00:00:00,480.906,2101.4,1882,101,1682,64,73,53,88,68.5,9,70.5,35
2007-06-13 06:00:00,108.788,500.4,0,125,578,55,64,82,100,59.5,9,91.0,18
2007-06-13 12:00:00,267.526,1153.0,0,241,2484,57,73,57,100,65.0,16,78.5,43
2007-06-13 18:00:00,196.28,883.4,957,364,658,75,79,44,61,77.0,4,52.5,17
2007-06-14 00:00:00,354.678,1520.4,0,127,1496,64,68,83,88,66.0,4,85.5,5
2007-06-14 06:00:00,68.53399999999999,325.0,0,127,0,59,63,94,100,61.0,4,97.0,6
2007-06-14 12:00:00,326.574,1380.6,0,94,3638,61,73,69,94,67.0,12,81.5,25
2007-06-14 18:00:00,71.44,353.6,0,125,0,68,72,69,83,70.0,4,76.0,14
2007-06-15 00:00:00,792.5360000000001,3388.8,3322,1801,3416,63,73,69,94,68.0,10,81.5,25
2007-06-15 06:00:00,159.222,752.0,440,811,451,59,63,94,94,61.0,4,94.0,0
2007-06-15 12:00:00,345.31,1518.4,0,2474,1753,59,66,73,88,62.5,7,80.5,15
2007-06-15 18:00:00,88.46600000000001,425.8,104,212,45,63,70,56,88,66.5,7,72.0,32
2007-06-16 00:00:00,396.606,1719.2,1725,514,2298,61,68,64,88,64.5,7,76.0,24
2007-06-16 06:00:00,119.504,530.0,0,189,543,57,59,82,88,58.0,2,85.0,6
2007-06-16 12:00:00,381.456,1639.8000000000002,0,1493,3063,57,63,77,88,60.0,6,82.5,11
2007-06-16 18:00:00,676.746,2881.4,471,2406,3143,66,70,49,64,68.0,4,56.5,15
2007-06-17 00:00:00,840.056,3552.8,2818,410,4359,61,64,59,77,62.5,3,68.0,18
2007-06-17 06:00:00,290.998,1240.4,922,268,670,52,57,82,94,54.5,5,88.0,12
2007-06-17 12:00:00,291.06600000000003,1240.0,0,436,2825,52,70,53,94,61.0,18,73.5,41
2007-06-17 18:00:00,593.316,2554.2,887,3378,1651,63,72,50,94,67.5,9,72.0,44
2007-06-18 00:00:00,771.71,3273.2,2315,956,3588,59,64,77,94,61.5,5,85.5,17
2007-06-18 06:00:00,68.726,324.0,0,145,0,57,61,88,100,59.0,4,94.0,12
2007-06-18 12:00:00,320.654,1364.0,0,130,3634,61,72,64,94,66.5,11,79.0,30
2007-06-18 18:00:00,63.574,309.4,0,109,0,75,79,47,54,77.0,4,50.5,7
2007-06-19 00:00:00,225.52,996.0,0,145,607,61,77,47,94,69.0,16,70.5,47
2007-06-19 06:00:00,119.244,529.8,0,138,798,61,64,73,88,62.5,3,80.5,15
2007-06-19 12:00:00,317.988,1378.6,970,98,2342,63,68,82,88,65.5,5,85.0,6
2007-06-19 18:00:00,123.444,583.6,0,148,573,81,90,33,58,85.5,9,45.5,25
2007-06-20 00:00:00,281.684,1190.4,3,151,644,66,84,42,94,75.0,18,68.0,52
2007-06-20 06:00:00,61.66,299.4,0,113,0,59,66,82,94,62.5,7,88.0,12
2007-06-20 12:00:00,310.18,1351.0,891,124,2488,59,68,60,88,63.5,9,74.0,28
2007-06-20 18:00:00,194.912,895.5999999999999,0,153,946,70,75,47,53,72.5,5,50.0,6
2007-06-21 00:00:00,507.534,2215.8,870,2198,1672,66,75,44,94,70.5,9,69.0,50
2007-06-21 06:00:00,90.018,421.6,0,195,226,59,64,72,94,61.5,5,83.0,22
2007-06-21 12:00:00,308.572,1322.0,0,174,2977,59,68,60,94,63.5,9,77.0,34
2007-06-21 18:00:00,84.344,411.0,0,184,76,68,72,43,56,70.0,4,49.5,13
2007-06-22 00:00:00,324.012,1446.6,932,1847,432,63,70,46,64,66.5,7,55.0,18
2007-06-22 06:00:00,125.956,589.2,0,329,643,57,61,68,82,59.0,4,75.0,14
2007-06-22 12:00:00,246.76,1083.4,0,242,2208,57,63,72,88,60.0,6,80.0,16
2007-06-22 18:00:00,78.724,391.8,0,204,0,61,64,72,88,62.5,3,80.0,16
2007-06-23 00:00:00,114.854,538.2,0,176,631,59,61,68,94,60.0,2,81.0,26
2007-06-23 06:00:00,77.12,382.4,0,166,33,57,59,88,94,58.0,2,91.0,6
2007-06-23 12:00:00,135.046,613.1999999999999,0,243,783,57,64,68,94,60.5,7,81.0,26
2007-06-23 18:00:00,139.566,638.2,0,216,909,66,72,50,64,69.0,6,57.0,14
2007-06-24 00:00:00,125.834,577.6,0,161,677,59,68,60,94,63.5,9,77.0,34
2007-06-24 06:00:00,136.286,611.2,0,164,778,55,59,82,94,57.0,4,88.0,12
2007-06-24 12:00:00,84.848,416.4,0,241,0,55,64,68,88,59.5,9,78.0,20
2007-06-24 18:00:00,268.59000000000003,1135.6,0,217,1735,68,70,52,56,69.0,2,54.0,4
2007-06-25 00:00:00,224.932,1015.8,0,169,936,61,73,53,77,67.0,12,65.0,24
2007-06-25 06:00:00,88.53,416.6,0,163,0,59,64,77,88,61.5,5,82.5,11
2007-06-25 12:00:00,312.122,1332.6,0,229,3383,57,63,63,88,60.0,6,75.5,25
2007-06-25 18:00:00,86.646,418.8,0,237,0,66,70,38,46,68.0,4,42.0,8
2007-06-26 00:00:00,584.904,2512.0,1985,2992,1433,55,66,49,88,60.5,11,68.5,39
2007-06-26 06:00:00,132.22,605.4,1,253,596,55,55,88,94,55.0,0,91.0,6
2007-06-26 12:00:00,276.53000000000003,1183.8,0,163,2656,55,59,77,94,57.0,4,85.5,17
2007-06-26 18:00:00,80.676,400.4,0,251,0,59,61,63,72,60.0,2,67.5,9
2007-06-27 00:00:00,455.482,1953.4,970,667,1979,55,63,55,88,59.0,8,71.5,33
2007-06-27 06:00:00,85.806,395.6,0,196,0,52,54,82,88,53.0,2,85.0,6
2007-06-27 12:00:00,510.24,2152.4,0,1960,4856,52,61,59,88,56.5,9,73.5,29
2007-06-27 18:00:00,101.192,477.2,0,307,0,61,64,49,63,62.5,3,56.0,14
2007-06-28 00:00:00,783.588,3352.8,2603,3988,2414,54,63,55,88,58.5,9,71.5,33
2007-06-28 06:00:00,105.73,506.6,0,303,100,54,55,82,88,54.5,1,85.0,6
2007-06-28 12:00:00,369.294,1569.2,0,433,3768,55,63,63,82,59.0,8,72.5,19
2007-06-28 18:00:00,188.33,834.8,0,203,1662,64,66,49,59,65.0,2,54.0,10
2007-06-29 00:00:00,632.0840000000001,2690.4,0,3429,4011,57,64,52,77,60.5,7,64.5,25
2007-06-29 06:00:00,105.566,490.2,0,150,0,57,61,72,77,59.0,4,74.5,5
2007-06-29 12:00:00,267.166,1177.6,713,179,1575,57,61,72,77,59.0,4,74.5,5
2007-06-29 18:00:00,302.434,1328.4,568,207,2327,61,64,64,82,62.5,3,73.0,18
2007-06-30 00:00:00,629.032,2677.0,3082,131,2895,61,66,63,88,63.5,5,75.5,25
2007-06-30 06:00:00,88.39,430.4,0,236,47,59,63,82,88,61.0,4,85.0,6
2007-06-30 12:00:00,280.588,1199.0,0,117,2765,59,66,78,94,62.5,7,86.0,16
2007-06-30 18:00:00,288.236,1245.2,1308,309,1197,66,73,57,83,69.5,7,70.0,26
2007-07-01 00:00:00,678.1,2844.4,1741,130,4367,63,73,57,83,68.0,10,70.0,26
2007-07-01 06:00:00,334.156,1413.8,969,237,1126,63,63,82,88,63.0,0,85.0,6
2007-07-01 12:00:00,295.212,1235.0,0,133,2147,63,68,78,88,65.5,5,83.0,10
2007-07-01 18:00:00,123.85,571.8,0,235,232,68,73,50,73,70.5,5,61.5,23
2007-07-02 00:00:00,273.446,1215.6,0,131,1185,63,72,60,83,67.5,9,71.5,23
2007-07-02 06:00:00,78.886,374.0,0,249,0,59,61,88,94,60.0,2,91.0,6
2007-07-02 12:00:00,177.56,775.6,0,122,1349,59,66,64,88,62.5,7,76.0,24
2007-07-02 18:00:00,116.32,526.6,0,246,636,66,73,38,64,69.5,7,51.0,26
2007-07-03 00:00:00,594.2660000000001,2539.8,1018,4664,1460,61,70,46,82,65.5,9,64.0,36
2007-07-03 06:00:00,117.064,561.6,0,238,0,57,61,72,82,59.0,4,77.0,10
2007-07-03 12:00:00,331.15,1415.0,0,242,3083,55,59,94,94,57.0,4,94.0,0
2007-07-03 18:00:00,90.95,437.8,0,141,0,61,68,78,94,64.5,7,86.0,16
2007-07-04 00:00:00,520.748,2237.8,467,2593,1612,61,64,64,88,62.5,3,76.0,24
2007-07-04 06:00:00,126.1,572.2,508,249,0,54,57,72,88,55.5,3,80.0,16
2007-07-04 12:00:00,403.454,1721.0,0,1441,3393,54,63,68,88,58.5,9,78.0,20
2007-07-04 18:00:00,84.306,389.6,0,141,0,63,66,52,73,64.5,3,62.5,21
2007-07-05 00:00:00,389.55,1774.6,1821,387,2239,57,64,64,77,60.5,7,70.5,13
2007-07-05 06:00:00,98.448,501.2,0,164,0,55,57,72,77,56.0,2,74.5,5
2007-07-05 12:00:00,263.218,1141.2,0,254,2488,57,64,68,88,60.5,7,78.0,20
2007-07-05 18:00:00,93.958,455.6,0,218,0,64,66,52,64,65.0,2,58.0,12
2007-07-06 00:00:00,601.666,2557.8,2922,134,1485,57,66,56,94,61.5,9,75.0,38
2007-07-06 06:00:00,117.384,546.0,241,182,377,59,61,88,94,60.0,2,91.0,6
2007-07-06 12:00:00,181.852,809.8,0,233,1167,59,64,64,88,61.5,5,76.0,24
2007-07-06 18:00:00,82.502,411.2000000000001,0,247,0,68,72,43,52,70.0,4,47.5,9
2007-07-07 00:00:00,687.7860000000001,2939.8,2585,2901,2461,57,70,46,88,63.5,13,67.0,42
2007-07-07 06:00:00,380.43,1628.4,0,2547,1679,55,57,72,82,56.0,2,77.0,10
2007-07-07 12:00:00,282.88,1206.8,0,185,2847,57,63,59,82,60.0,6,70.5,23
2007-07-07 18:00:00,273.736,1185.4,471,137,2001,64,72,50,64,68.0,8,57.0,14
2007-07-08 00:00:00,421.16,1789.6,526,178,3650,57,70,49,67,63.5,13,58.0,18
2007-07-08 06:00:00,248.134,1071.6,0,280,1874,57,61,63,77,59.0,4,70.0,14
2007-07-08 12:00:00,196.574,871.0,8,396,1147,59,68,52,77,63.5,9,64.5,25
2007-07-08 18:00:00,307.53200000000004,1338.0,933,1138,1296,61,70,49,82,65.5,9,65.5,33
2007-07-09 00:00:00,336.84,1456.0,884,1017,960,57,63,59,88,60.0,6,73.5,29
2007-07-09 06:00:00,165.158,729.4,0,170,990,50,52,94,100,51.0,2,97.0,6
2007-07-09 12:00:00,407.166,1708.4,0,153,4914,54,61,72,94,57.5,7,83.0,22
2007-07-09 18:00:00,170.766,753.6,0,117,1041,54,64,64,88,59.0,10,76.0,24
2007-07-10 00:00:00,437.068,1872.0,923,154,2441,54,61,68,94,57.5,7,81.0,26
2007-07-10 06:00:00,151.684,682.6,67,157,700,52,54,88,94,53.0,2,91.0,6
2007-07-10 12:00:00,258.394,1110.6,0,152,2326,52,55,88,94,53.5,3,91.0,6
2007-07-10 18:00:00,115.928,533.4,0,158,609,55,64,68,88,59.5,9,78.0,20
2007-07-11 00:00:00,382.318,1685.4,0,1760,996,52,63,82,94,57.5,11,88.0,12
2007-07-11 06:00:00,101.074,461.2,0,231,334,54,55,88,94,54.5,1,91.0,6
2007-07-11 12:00:00,415.794,1751.4,1015,139,4253,55,64,77,88,59.5,9,82.5,11
2007-07-11 18:00:00,79.754,381.6,0,137,0,64,70,52,68,67.0,6,60.0,16
2007-07-12 00:00:00,125.73,573.0,0,140,697,55,68,56,94,61.5,13,75.0,38
2007-07-12 06:00:00,130.49,586.4,0,142,739,54,55,88,94,54.5,1,91.0,6
2007-07-12 12:00:00,177.156,778.8,0,142,1357,54,64,73,88,59.0,10,80.5,15
2007-07-12 18:00:00,133.86,605.6,0,142,791,66,70,68,78,68.0,4,73.0,10
2007-07-13 00:00:00,628.076,2685.6,1029,2124,3532,68,70,73,78,69.0,2,75.5,5
2007-07-13 06:00:00,89.534,416.8,0,151,0,59,64,83,94,61.5,5,88.5,11
2007-07-13 12:00:00,350.532,1484.6,0,153,3703,61,75,61,94,68.0,14,77.5,33
2007-07-13 18:00:00,87.026,422.2,0,160,0,77,84,42,61,80.5,7,51.5,19
2007-07-14 00:00:00,267.29,1205.6,0,169,724,66,82,42,83,74.0,16,62.5,41
2007-07-14 06:00:00,132.57,593.0,0,166,653,66,72,64,78,69.0,6,71.0,14
2007-07-14 12:00:00,342.53,1459.8000000000002,909,168,3035,66,77,61,78,71.5,11,69.5,17
2007-07-14 18:00:00,312.002,1386.8,730,1458,804,79,86,43,57,82.5,7,50.0,14
2007-07-15 00:00:00,501.068,2167.8,2136,176,2112,72,86,40,78,79.0,14,59.0,38
2007-07-15 06:00:00,97.52,469.2,0,183,0,63,72,78,94,67.5,9,86.0,16
2007-07-15 12:00:00,156.168,719.4,0,180,520,66,79,50,88,72.5,13,69.0,38
2007-07-15 18:00:00,266.286,1175.8,862,92,1733,82,90,36,42,86.0,8,39.0,6
2007-07-16 00:00:00,397.05,1685.6,0,177,3332,72,90,35,83,81.0,18,59.0,48
2007-07-16 06:00:00,106.086,495.4,0,171,234,68,72,68,78,70.0,4,73.0,10
2007-07-16 12:00:00,235.486,1042.8,0,169,2014,68,77,47,83,72.5,9,65.0,36
2007-07-16 18:00:00,188.822,862.0,830,170,548,70,77,47,78,73.5,7,62.5,31
2007-07-17 00:00:00,323.28,1431.0,0,185,1380,61,72,69,94,66.5,11,81.5,25
2007-07-17 06:00:00,83.814,402.4,0,176,0,57,72,69,100,64.5,15,84.5,31
2007-07-17 12:00:00,276.546,1228.4,848,168,1916,57,72,60,94,64.5,15,77.0,34
2007-07-17 18:00:00,81.042,392.6,0,174,0,72,77,39,57,74.5,5,48.0,18
2007-07-18 00:00:00,278.23,1254.4,0,176,1419,61,77,41,88,69.0,16,64.5,47
2007-07-18 06:00:00,78.048,378.4,0,168,0,59,64,68,82,61.5,5,75.0,14
2007-07-18 12:00:00,460.77,2025.4,909,163,4014,59,72,56,82,65.5,13,69.0,26
2007-07-18 18:00:00,80.928,393.6,0,167,0,73,77,34,47,75.0,4,40.5,13
2007-07-19 00:00:00,137.33599999999998,639.6,0,173,614,63,75,38,68,69.0,12,53.0,30
2007-07-19 06:00:00,104.794,492.2,0,168,403,61,66,68,77,63.5,5,72.5,9
2007-07-19 12:00:00,200.732,902.0,0,175,1363,61,75,53,77,68.0,14,65.0,24
2007-07-19 18:00:00,90.762,434.4,0,175,135,75,79,42,50,77.0,4,46.0,8
2007-07-20 00:00:00,281.598,1258.6,1068,185,1229,66,79,47,64,72.5,13,55.5,17
2007-07-20 06:00:00,122.348,559.2,0,183,650,64,70,73,88,67.0,6,80.5,15
2007-07-20 12:00:00,216.826,988.0,0,177,1509,63,68,73,94,65.5,5,83.5,21
2007-07-20 18:00:00,228.794,1062.2,0,538,1210,68,73,46,68,70.5,5,57.0,22
2007-07-21 00:00:00,542.4540000000001,2361.0,2111,1520,1396,59,72,46,82,65.5,13,64.0,36
2007-07-21 06:00:00,75.562,368.8,0,169,0,52,57,77,94,54.5,5,85.5,17
2007-07-21 12:00:00,354.81,1569.4,0,168,3585,54,68,52,94,61.0,14,73.0,42
2007-07-21 18:00:00,250.18,1154.4,0,175,2032,70,72,41,46,71.0,2,43.5,5
2007-07-22 00:00:00,379.696,1647.2,428,0,2139,57,70,40,82,63.5,13,61.0,42
2007-07-22 06:00:00,116.662,529.8,536,0,169,54,59,67,88,56.5,5,77.5,21
2007-07-22 12:00:00,444.22399999999993,1959.6,2391,362,2195,54,64,59,88,59.0,10,73.5,29
2007-07-22 18:00:00,354.34,1567.0,2122,364,1360,68,72,46,52,70.0,4,49.0,6
2007-07-23 00:00:00,460.548,2025.6,2042,1410,1839,61,72,46,68,66.5,11,57.0,22
2007-07-23 06:00:00,74.97,356.6,0,84,0,59,61,68,88,60.0,2,78.0,20
2007-07-23 12:00:00,269.926,1196.4,387,294,1369,59,63,88,94,61.0,4,91.0,6
2007-07-23 18:00:00,341.21,1512.8,461,910,1208,61,70,68,94,65.5,9,81.0,26
2007-07-24 00:00:00,304.912,1363.6,899,0,1270,59,64,68,88,61.5,5,78.0,20
2007-07-24 06:00:00,93.596,435.4,0,0,505,59,59,82,88,59.0,0,85.0,6
2007-07-24 12:00:00,370.634,1597.1999999999998,0,0,4036,59,68,64,94,63.5,9,79.0,30
2007-07-24 18:00:00,70.26599999999999,329.8,0,0,0,68,73,47,56,70.5,5,51.5,9
2007-07-25 00:00:00,290.788,1311.0,0,1607,1058,59,70,56,88,64.5,11,72.0,32
2007-07-25 06:00:00,117.898,535.4,0,139,675,54,57,88,100,55.5,3,94.0,12
2007-07-25 12:00:00,162.346,720.8,0,12,972,54,64,77,100,59.0,10,88.5,23
2007-07-25 18:00:00,85.53999999999999,392.4,0,0,309,66,75,41,78,70.5,9,59.5,37
2007-07-26 00:00:00,106.776,481.6,0,0,377,59,75,38,82,67.0,16,60.0,44
2007-07-26 06:00:00,112.426,501.6,0,0,747,57,63,72,88,60.0,6,80.0,16
2007-07-26 12:00:00,281.998,1226.4,975,0,2196,57,72,57,88,64.5,15,72.5,31
2007-07-26 18:00:00,68.426,321.8,0,0,0,72,77,47,61,74.5,5,54.0,14
2007-07-27 00:00:00,461.65,2037.2,0,3633,1403,64,75,50,68,69.5,11,59.0,18
2007-07-27 06:00:00,103.48,468.4,0,49,605,61,64,73,82,62.5,3,77.5,9
2007-07-27 12:00:00,345.848,1498.4,903,0,2909,61,64,82,94,62.5,3,88.0,12
2007-07-27 18:00:00,290.776,1248.4,0,0,2590,64,75,53,88,69.5,11,70.5,35
2007-07-28 00:00:00,462.41,2002.4,934,0,1053,66,73,57,68,69.5,7,62.5,11
2007-07-28 06:00:00,86.208,402.6,0,0,256,64,68,68,83,66.0,4,75.5,15
2007-07-28 12:00:00,300.99,1339.8,0,2082,811,63,72,69,94,67.5,9,81.5,25
2007-07-28 18:00:00,717.468,3137.2,907,6143,2183,70,72,53,64,71.0,2,58.5,11
2007-07-29 00:00:00,517.196,2236.4,0,2040,3309,61,70,56,77,65.5,9,66.5,21
2007-07-29 06:00:00,62.024,296.8,0,0,0,61,63,77,88,62.0,2,82.5,11
2007-07-29 12:00:00,94.702,431.8,0,0,555,63,70,83,88,66.5,7,85.5,5
2007-07-29 18:00:00,60.058,287.2,0,0,0,64,70,64,94,67.0,6,79.0,30
2007-07-30 00:00:00,104.332,472.4,0,0,733,59,63,72,82,61.0,4,77.0,10
2007-07-30 06:00:00,60.048,285.6,0,0,0,48,57,77,93,52.5,9,85.0,16
2007-07-30 12:00:00,119.242,532.2,0,0,892,48,68,43,100,58.0,20,71.5,57
2007-07-30 18:00:00,61.214,294.0,0,0,0,68,72,33,43,70.0,4,38.0,10
2007-07-31 00:00:00,226.312,1001.0,0,0,1636,59,70,38,72,64.5,11,55.0,34
2007-07-31 06:00:00,66.18,310.0,0,0,104,50,57,63,87,53.5,7,75.0,24
2007-07-31 12:00:00,109.644,492.4,0,0,803,50,66,49,87,58.0,16,68.0,38
2007-07-31 18:00:00,305.372,1377.8,2313,0,776,68,72,33,46,70.0,4,39.5,13
2007-08-01 00:00:00,331.136,1423.4,964,0,1892,57,70,35,59,63.5,13,47.0,24
2007-08-01 06:00:00,165.856,727.0,0,0,921,55,61,55,63,58.0,6,59.0,8
2007-08-01 12:00:00,385.276,1669.4,667,0,3756,54,72,43,72,63.0,18,57.5,29
2007-08-01 18:00:00,444.168,1904.4,916,0,5135,73,81,36,44,77.0,8,40.0,8
2007-08-02 00:00:00,65.038,315.8,0,0,0,61,81,37,60,71.0,20,48.5,23
2007-08-02 06:00:00,218.772,959.8,0,0,876,63,70,64,83,66.5,7,73.5,19
2007-08-02 12:00:00,252.97,1127.4,482,0,1660,59,70,56,94,64.5,11,75.0,38
2007-08-02 18:00:00,310.136,1330.6,0,0,3995,70,73,47,56,71.5,3,51.5,9
2007-08-03 00:00:00,237.538,1027.6,0,0,338,59,70,56,94,64.5,11,75.0,38
2007-08-03 06:00:00,186.262,799.4,0,0,536,70,70,56,56,70.0,0,56.0,0
2007-08-03 12:00:00,406.436,1750.2,451,0,4609,70,70,56,56,70.0,0,56.0,0
2007-08-03 18:00:00,346.338,1494.2,507,0,3994,70,70,56,56,70.0,0,56.0,0
2007-08-04 00:00:00,124.328,574.5999999999999,0,0,0,70,70,56,56,70.0,0,56.0,0
2007-08-04 06:00:00,217.276,930.6,0,0,910,54,59,82,100,56.5,5,91.0,18
2007-08-04 12:00:00,359.092,1555.4,552,398,3271,54,77,47,100,65.5,23,73.5,53
2007-08-04 18:00:00,333.148,1439.8,0,0,3325,77,82,37,44,79.5,5,40.5,7
2007-08-05 00:00:00,235.474,1045.6,0,0,460,61,82,37,77,71.5,21,57.0,40
2007-08-05 06:00:00,211.138,952.4,0,0,1659,61,68,60,82,64.5,7,71.0,22
2007-08-05 12:00:00,317.45,1387.2,169,0,2982,59,81,54,88,70.0,22,71.0,34
2007-08-05 18:00:00,149.952,669.6,0,0,1308,84,91,29,48,87.5,7,38.5,19
2007-08-06 00:00:00,108.558,499.8,0,0,698,70,90,29,60,80.0,20,44.5,31
2007-08-06 06:00:00,215.346,948.8,0,0,1454,66,70,68,83,68.0,4,75.5,15
2007-08-06 12:00:00,542.314,2342.6,1096,0,4658,64,70,73,94,67.0,6,83.5,21
2007-08-06 18:00:00,172.18,766.2,0,0,1539,63,66,77,88,64.5,3,82.5,11
2007-08-07 00:00:00,159.88,719.0,0,0,334,59,72,64,94,65.5,13,79.0,30
2007-08-07 06:00:00,223.768,966.2,0,0,516,50,59,82,100,54.5,9,91.0,18
2007-08-07 12:00:00,389.544,1695.6,437,620,3525,50,70,49,100,60.0,20,74.5,51
2007-08-07 18:00:00,546.472,2346.0,0,1257,5001,68,73,41,52,70.5,5,46.5,11
2007-08-08 00:00:00,323.796,1365.6,0,291,0,59,66,56,94,62.5,7,75.0,38
2007-08-08 06:00:00,313.746,1351.0,0,0,3247,55,57,94,100,56.0,2,97.0,6
2007-08-08 12:00:00,446.314,1941.6,1055,960,3176,55,59,88,94,57.0,4,91.0,6
2007-08-08 18:00:00,278.226,1187.4,0,91,3237,59,63,82,94,61.0,4,88.0,12
2007-08-09 00:00:00,87.196,388.0,0,60,0,57,63,72,88,60.0,6,80.0,16
2007-08-09 06:00:00,267.496,1173.4,0,1072,963,54,59,72,88,56.5,5,80.0,16
2007-08-09 12:00:00,511.892,2244.0,182,2889,3480,54,61,68,88,57.5,7,78.0,20
2007-08-09 18:00:00,234.224,1021.6,0,554,2203,63,64,56,63,63.5,1,59.5,7
2007-08-10 00:00:00,58.068,273.2,0,0,0,59,63,59,77,61.0,4,68.0,18
2007-08-10 06:00:00,135.288,593.6,0,0,913,57,61,72,88,59.0,4,80.0,16
2007-08-10 12:00:00,481.096,2104.2,336,2309,3753,57,61,88,94,59.0,4,91.0,6
2007-08-10 18:00:00,281.988,1215.4,0,180,3543,61,64,77,88,62.5,3,82.5,11
2007-08-11 00:00:00,129.638,593.6,0,162,78,59,64,77,88,61.5,5,82.5,11
2007-08-11 06:00:00,138.754,629.1999999999999,0,162,983,61,63,82,88,62.0,2,85.0,6
2007-08-11 12:00:00,443.894,1924.2,1180,715,3661,61,64,82,88,62.5,3,85.0,6
2007-08-11 18:00:00,404.04,1709.4,0,33,5695,66,70,68,78,68.0,4,73.0,10
2007-08-12 00:00:00,104.962,468.6,0,0,0,61,70,73,88,65.5,9,80.5,15
2007-08-12 06:00:00,154.488,669.8,0,0,860,55,59,94,100,57.0,4,97.0,6
2007-08-12 12:00:00,389.478,1694.6,462,344,3731,59,70,78,100,64.5,11,89.0,22
2007-08-12 18:00:00,162.364,705.8,0,0,1687,73,77,54,69,75.0,4,61.5,15
2007-08-13 00:00:00,535.5740000000001,2319.4,661,812,2304,61,66,83,88,63.5,5,85.5,5
2007-08-13 06:00:00,266.458,1165.8,0,412,2428,55,59,88,94,57.0,4,91.0,6
2007-08-13 12:00:00,367.508,1584.2,93,64,3967,55,66,56,94,60.5,11,75.0,38
2007-08-13 18:00:00,315.136,1335.2,0,0,4248,70,73,44,53,71.5,3,48.5,9
2007-08-14 00:00:00,203.91,881.0,0,0,458,59,70,53,82,64.5,11,67.5,29
2007-08-14 06:00:00,107.61,481.2,0,0,667,54,57,82,94,55.5,3,88.0,12
2007-08-14 12:00:00,415.586,1779.4,951,366,3785,55,72,57,88,63.5,17,72.5,31
2007-08-14 18:00:00,183.628,813.0,0,0,1804,72,75,50,57,73.5,3,53.5,7
2007-08-15 00:00:00,234.366,1036.4,0,319,0,59,66,82,94,62.5,7,88.0,12
2007-08-15 06:00:00,295.144,1277.6,0,193,2456,68,68,88,88,68.0,0,88.0,0
2007-08-15 12:00:00,443.032,1902.8,338,287,3195,68,70,83,88,69.0,2,85.5,5
2007-08-15 18:00:00,324.368,1354.4,0,28,4136,66,66,88,94,66.0,0,91.0,6
2007-08-16 00:00:00,129.316,565.8,0,0,0,64,64,88,94,64.0,0,91.0,6
2007-08-16 06:00:00,181.458,776.0,0,0,947,59,63,82,88,61.0,4,85.0,6
2007-08-16 12:00:00,470.352,1994.6,962,0,4473,57,66,64,88,61.5,9,76.0,24
2007-08-16 18:00:00,156.588,674.4,0,0,1441,63,68,52,68,65.5,5,60.0,16
2007-08-17 00:00:00,150.098,650.2,0,0,615,55,63,72,94,59.0,8,83.0,22
2007-08-17 06:00:00,312.976,1318.0,0,0,2666,54,55,82,94,54.5,1,88.0,12
2007-08-17 12:00:00,527.348,2212.0,244,0,4291,55,66,60,82,60.5,11,71.0,22
2007-08-17 18:00:00,60.098,281.8,0,0,0,66,68,49,60,67.0,2,54.5,11
2007-08-18 00:00:00,109.47,481.6,0,0,812,55,64,56,94,59.5,9,75.0,38
2007-08-18 06:00:00,59.52,275.0,0,0,0,50,54,88,94,52.0,4,91.0,6
2007-08-18 12:00:00,112.676,494.2,0,0,894,52,66,60,94,59.0,14,77.0,34
2007-08-18 18:00:00,60.154,282.4,0,0,0,66,70,49,60,68.0,4,54.5,11
2007-08-19 00:00:00,115.61,502.0,0,0,936,55,68,52,82,61.5,13,67.0,30
2007-08-19 06:00:00,60.2,282.4,0,0,0,57,63,68,94,60.0,6,81.0,26
2007-08-19 12:00:00,118.508,518.0,0,0,988,57,63,88,100,60.0,6,94.0,12
2007-08-19 18:00:00,553.25,2398.4,1025,4599,1299,64,68,77,88,66.0,4,82.5,11
2007-08-20 00:00:00,690.336,2938.4,0,4313,3702,59,64,64,82,61.5,5,73.0,18
2007-08-20 06:00:00,65.266,317.4,0,44,0,55,57,88,94,56.0,2,91.0,6
2007-08-20 12:00:00,344.338,1458.0,0,260,3610,55,57,82,94,56.0,2,88.0,12
2007-08-20 18:00:00,555.73,2343.6,1032,3223,3075,57,64,64,88,60.5,7,76.0,24
2007-08-21 00:00:00,373.508,1588.2,0,3438,698,59,63,72,82,61.0,4,77.0,10
2007-08-21 06:00:00,71.876,352.0,0,38,0,54,57,88,94,55.5,3,91.0,6
2007-08-21 12:00:00,207.062,887.2,0,0,1850,52,66,60,94,59.0,14,77.0,34
2007-08-21 18:00:00,73.452,333.6,0,0,176,66,70,53,73,68.0,4,63.0,20
2007-08-22 00:00:00,290.166,1251.2,0,0,1270,59,68,64,77,63.5,9,70.5,13
2007-08-22 06:00:00,102.982,458.6,0,0,610,61,63,88,94,62.0,2,91.0,6
2007-08-22 12:00:00,306.464,1299.8,976,0,2564,61,64,88,94,62.5,3,91.0,6
2007-08-22 18:00:00,62.006,281.6,0,0,0,61,66,88,94,63.5,5,91.0,6
2007-08-23 00:00:00,738.356,3102.6,2072,1836,4067,61,63,88,94,62.0,2,91.0,6
2007-08-23 06:00:00,108.782,487.8,0,86,703,61,61,94,100,61.0,0,97.0,6
2007-08-23 12:00:00,358.166,1542.0,1027,8,1801,61,63,94,94,62.0,2,94.0,0
2007-08-23 18:00:00,299.132,1282.4,1016,0,2056,63,66,88,100,64.5,3,94.0,12
2007-08-24 00:00:00,346.232,1483.4,459,165,782,61,64,88,94,62.5,3,91.0,6
2007-08-24 06:00:00,154.306,707.2,488,305,579,61,63,94,94,62.0,2,94.0,0
2007-08-24 12:00:00,320.47,1386.4,0,575,2682,61,66,83,94,63.5,5,88.5,11
2007-08-24 18:00:00,421.378,1782.6,0,1484,3688,68,72,69,83,70.0,4,76.0,14
2007-08-25 00:00:00,760.06,3230.4,1403,1418,2995,59,70,78,94,64.5,11,86.0,16
2007-08-25 06:00:00,307.19800000000004,1349.6,930,1485,1029,55,59,94,100,57.0,4,97.0,6
2007-08-25 12:00:00,139.73,646.8,0,175,518,55,68,83,94,61.5,13,88.5,11
2007-08-25 18:00:00,470.2,2050.0,2273,191,3430,70,77,54,78,73.5,7,66.0,24
2007-08-26 00:00:00,233.752,1071.0,946,340,701,59,75,57,94,67.0,16,75.5,37
2007-08-26 06:00:00,127.566,578.0,0,149,577,57,63,94,100,60.0,6,97.0,6
2007-08-26 12:00:00,275.796,1209.1999999999998,0,583,2000,57,73,69,94,65.0,16,81.5,25
2007-08-26 18:00:00,562.8,2439.4,1541,2510,2236,73,77,54,69,75.0,4,61.5,15
2007-08-27 00:00:00,348.744,1551.6,0,403,845,64,75,61,88,69.5,11,74.5,27
2007-08-27 06:00:00,92.512,486.4,0,392,0,59,64,88,94,61.5,5,91.0,6
2007-08-27 12:00:00,481.604,2043.8,943,387,5143,57,68,60,94,62.5,11,77.0,34
2007-08-27 18:00:00,96.848,493.2,0,386,113,70,72,46,56,71.0,2,51.0,10
2007-08-28 00:00:00,540.766,2292.0,1362,64,1088,61,70,53,83,65.5,9,68.0,30
2007-08-28 06:00:00,216.868,935.8,496,71,981,54,57,77,88,55.5,3,82.5,11
2007-08-28 12:00:00,340.914,1451.2,0,87,3374,54,64,64,88,59.0,10,76.0,24
2007-08-28 18:00:00,153.2,695.0,542,98,636,66,70,49,56,68.0,4,52.5,7
2007-08-29 00:00:00,286.022,1232.4,0,2212,492,59,66,59,72,62.5,7,65.5,13
2007-08-29 06:00:00,111.512,511.0,0,202,550,54,59,72,77,56.5,5,74.5,5
2007-08-29 12:00:00,341.224,1456.0,957,119,2662,54,63,55,77,58.5,9,66.0,22
2007-08-29 18:00:00,76.674,368.4,0,136,0,64,68,37,52,66.0,4,44.5,15
2007-08-30 00:00:00,218.582,947.2,0,105,1720,59,66,46,77,62.5,7,61.5,31
2007-08-30 06:00:00,104.776,474.2,0,105,587,50,57,59,82,53.5,7,70.5,23
2007-08-30 12:00:00,245.974,1084.4,901,131,1305,50,64,56,82,57.0,14,69.0,26
2007-08-30 18:00:00,147.568,646.8,0,110,1060,66,70,46,52,68.0,4,49.0,6
2007-08-31 00:00:00,704.14,2984.8,2921,2234,1269,57,68,52,72,62.5,11,62.0,20
2007-08-31 06:00:00,140.544,606.0,0,235,0,61,63,72,88,62.0,2,80.0,16
2007-08-31 12:00:00,479.012,1997.2,0,106,5393,59,68,60,88,63.5,9,74.0,28
2007-08-31 18:00:00,99.754,453.0,0,117,307,68,70,53,60,69.0,2,56.5,7
2007-09-01 00:00:00,560.512,2399.2000000000003,1200,208,3038,63,66,64,72,64.5,3,68.0,8
2007-09-01 06:00:00,80.662,389.8,0,133,0,59,61,77,88,60.0,2,82.5,11
2007-09-01 12:00:00,308.282,1336.6,0,118,2607,59,64,82,94,61.5,5,88.0,12
2007-09-01 18:00:00,556.844,2386.2,1085,143,4556,66,70,64,78,68.0,4,71.0,14
2007-09-02 00:00:00,755.698,3181.6,1412,175,2570,59,70,64,88,64.5,11,76.0,24
2007-09-02 06:00:00,181.904,815.8,892,252,496,55,59,88,94,57.0,4,91.0,6
2007-09-02 12:00:00,186.852,819.0,0,120,722,57,68,68,94,62.5,11,81.0,26
2007-09-02 18:00:00,688.5840000000001,2959.2,905,771,5583,66,70,56,68,68.0,4,62.0,12
2007-09-03 00:00:00,605.1279999999999,2630.8,1816,474,2005,57,66,60,88,61.5,9,74.0,28
2007-09-03 06:00:00,105.336,478.0,0,160,189,55,59,82,94,57.0,4,88.0,12
2007-09-03 12:00:00,530.92,2247.6,0,2019,4023,59,63,77,94,61.0,4,85.5,17
2007-09-03 18:00:00,81.764,403.6,0,228,0,63,64,52,68,63.5,1,60.0,16
2007-09-04 00:00:00,320.90200000000004,1379.0,621,108,1111,55,63,52,88,59.0,8,70.0,36
2007-09-04 06:00:00,96.004,452.2,0,143,346,50,54,76,82,52.0,4,79.0,6
2007-09-04 12:00:00,401.496,1716.8,1037,143,3417,50,61,55,82,55.5,11,68.5,27
2007-09-04 18:00:00,477.784,2081.6,978,1601,2809,63,64,42,48,63.5,1,45.0,6
2007-09-05 00:00:00,609.66,2598.0,913,1614,3249,55,63,45,77,59.0,8,61.0,32
2007-09-05 06:00:00,118.504,530.2,0,208,596,46,52,76,87,49.0,6,81.5,11
2007-09-05 12:00:00,479.6,2046.8,0,2721,2944,45,59,59,93,52.0,14,76.0,34
2007-09-05 18:00:00,84.352,399.4,0,152,148,63,68,40,52,65.5,5,46.0,12
2007-09-06 00:00:00,554.116,2348.2,0,1063,3017,54,64,59,67,59.0,10,63.0,8
2007-09-06 06:00:00,136.882,628.0,0,1245,0,59,61,77,88,60.0,2,82.5,11
2007-09-06 12:00:00,305.164,1305.2,0,159,2875,61,66,78,94,63.5,5,86.0,16
2007-09-06 18:00:00,87.24600000000001,418.4,0,180,177,66,70,68,78,68.0,4,73.0,10
2007-09-07 00:00:00,372.182,1611.6,0,2304,409,61,68,77,88,64.5,7,82.5,11
2007-09-07 06:00:00,109.744,500.0,0,125,685,61,63,82,88,62.0,2,85.0,6
2007-09-07 12:00:00,565.488,2389.8,1034,169,5841,61,66,64,88,63.5,5,76.0,24
2007-09-07 18:00:00,125.606,569.6,0,117,835,66,70,56,64,68.0,4,60.0,8
2007-09-08 00:00:00,535.658,2311.0,2598,140,2027,61,66,64,72,63.5,5,68.0,8
2007-09-08 06:00:00,79.912,387.4,0,152,0,57,61,72,88,59.0,4,80.0,16
2007-09-08 12:00:00,326.842,1392.0,0,693,2886,55,66,68,94,60.5,11,81.0,26
2007-09-08 18:00:00,497.336,2152.6,2462,842,2508,70,73,50,60,71.5,3,55.0,10
2007-09-09 00:00:00,565.662,2392.4,877,114,3770,59,72,50,82,65.5,13,66.0,32
2007-09-09 06:00:00,84.516,400.2,0,180,0,57,61,88,94,59.0,4,91.0,6
2007-09-09 12:00:00,263.63800000000003,1159.2,881,495,785,57,64,73,94,60.5,7,83.5,21
2007-09-09 18:00:00,599.58,2608.2,1303,1994,3401,66,68,52,64,67.0,2,58.0,12
2007-09-10 00:00:00,731.768,3110.2,0,1769,5047,57,66,52,82,61.5,9,67.0,30
2007-09-10 06:00:00,158.856,688.4,0,167,1427,48,57,77,93,52.5,9,85.0,16
2007-09-10 12:00:00,251.872,1104.6,0,129,1541,48,66,56,94,57.0,18,75.0,38
2007-09-10 18:00:00,110.62,506.0,0,134,570,66,70,53,64,68.0,4,58.5,11
2007-09-11 00:00:00,596.028,2544.8,935,165,2075,55,66,64,88,60.5,11,76.0,24
2007-09-11 06:00:00,70.822,340.0,0,116,0,48,59,77,93,53.5,11,85.0,16
2007-09-11 12:00:00,171.05,750.2,0,166,604,46,63,59,93,54.5,17,76.0,34
2007-09-11 18:00:00,219.808,955.8,0,109,2100,63,64,52,56,63.5,1,54.0,4
2007-09-12 00:00:00,521.892,2205.0,943,159,3088,57,64,56,77,60.5,7,66.5,21
2007-09-12 06:00:00,264.648,1113.2,0,123,3161,48,55,82,94,51.5,7,88.0,12
2007-09-12 12:00:00,257.552,1122.2,0,547,811,50,63,68,94,56.5,13,81.0,26
2007-09-12 18:00:00,144.304,662.0,0,147,734,66,68,49,60,67.0,2,54.5,11
2007-09-13 00:00:00,621.26,2661.0,0,2400,3049,55,66,52,82,60.5,11,67.0,30
2007-09-13 06:00:00,75.618,368.0,0,260,0,52,55,77,82,53.5,3,79.5,5
2007-09-13 12:00:00,283.51,1218.0,0,438,2258,50,64,64,87,57.0,14,75.5,23
2007-09-13 18:00:00,251.384,1080.2,0,162,676,68,72,46,56,70.0,4,51.0,10
2007-09-14 00:00:00,535.87,2322.6000000000004,1175,1663,919,55,70,46,77,62.5,15,61.5,31
2007-09-14 06:00:00,168.018,793.2,0,165,615,48,54,82,93,51.0,6,87.5,11
2007-09-14 12:00:00,455.3,1934.6,0,134,4354,46,70,53,100,58.0,24,76.5,47
2007-09-14 18:00:00,75.016,364.8,0,115,0,70,73,47,53,71.5,3,50.0,6
2007-09-15 00:00:00,437.136,1867.8,901,262,835,59,70,52,72,64.5,11,62.0,20
2007-09-15 06:00:00,144.402,658.4,0,149,719,57,61,72,88,59.0,4,80.0,16
2007-09-15 12:00:00,428.134,1805.0,0,138,4041,59,66,73,88,62.5,7,80.5,15
2007-09-15 18:00:00,223.352,991.2,0,1018,1043,68,72,53,64,70.0,4,58.5,11
2007-09-16 00:00:00,299.424,1266.0,0,144,661,57,70,56,88,63.5,13,72.0,32
2007-09-16 06:00:00,120.516,532.6,0,127,631,50,55,94,100,52.5,5,97.0,6
2007-09-16 12:00:00,260.702,1130.4,1074,120,1584,52,72,53,94,62.0,20,73.5,41
2007-09-16 18:00:00,389.074,1691.0,1,159,2959,75,79,39,50,77.0,4,44.5,11
2007-09-17 00:00:00,881.932,3797.4,2043,2658,4136,55,77,36,88,66.0,22,62.0,52
2007-09-17 06:00:00,91.232,429.2,0,200,222,55,61,63,88,58.0,6,75.5,25
2007-09-17 12:00:00,329.886,1414.6,896,144,2439,57,68,64,88,62.5,11,76.0,24
2007-09-17 18:00:00,73.738,356.6,0,150,0,64,70,64,73,67.0,6,68.5,9
2007-09-18 00:00:00,966.33,4155.0,5755,432,3618,54,63,63,88,58.5,9,75.5,25
2007-09-18 06:00:00,70.834,338.6,0,150,0,52,54,88,94,53.0,2,91.0,6
2007-09-18 12:00:00,387.06,1656.6,969,117,2665,52,55,67,88,53.5,3,77.5,21
2007-09-18 18:00:00,119.566,546.8,0,406,559,57,61,52,63,59.0,4,57.5,11
2007-09-19 00:00:00,590.0600000000001,2516.4,919,1356,2201,48,55,67,88,51.5,7,77.5,21
2007-09-19 06:00:00,70.548,341.4,0,109,0,41,43,93,93,42.0,2,93.0,0
2007-09-19 12:00:00,348.608,1471.2,0,113,3708,39,55,63,100,47.0,16,81.5,37
2007-09-19 18:00:00,484.0,2086.6000000000004,0,1868,3156,55,63,48,58,59.0,8,53.0,10
2007-09-20 00:00:00,395.528,1692.8,0,653,1073,45,61,48,87,53.0,16,67.5,39
2007-09-20 06:00:00,98.752,455.0,0,131,508,45,48,82,93,46.5,3,87.5,11
2007-09-20 12:00:00,503.272,2126.4,1056,131,4707,46,63,55,81,54.5,17,68.0,26
2007-09-20 18:00:00,68.314,324.4,0,116,0,64,70,33,45,67.0,6,39.0,12
2007-09-21 00:00:00,585.194,2452.4,0,111,4781,46,66,37,87,56.0,20,62.0,50
2007-09-21 06:00:00,88.54,414.0,0,114,358,45,48,87,93,46.5,3,90.0,6
2007-09-21 12:00:00,397.304,1675.2,0,139,4211,45,61,68,93,53.0,16,80.5,25
2007-09-21 18:00:00,68.902,338.8,0,136,0,66,72,41,52,69.0,6,46.5,11
2007-09-22 00:00:00,684.034,2947.0,3130,2356,1747,50,68,49,82,59.0,18,65.5,33
2007-09-22 06:00:00,71.862,344.8,0,183,0,46,54,87,93,50.0,8,90.0,6
2007-09-22 12:00:00,371.156,1580.0,0,159,3838,46,61,77,94,53.5,15,85.5,17
2007-09-22 18:00:00,367.086,1566.0,944,571,2937,61,70,56,77,65.5,9,66.5,21
2007-09-23 00:00:00,366.068,1571.0,0,398,913,54,68,60,88,61.0,14,74.0,28
2007-09-23 06:00:00,117.704,549.6,0,395,539,52,57,88,100,54.5,5,94.0,12
2007-09-23 12:00:00,293.414,1275.4,944,1059,624,55,68,68,94,61.5,13,81.0,26
2007-09-23 18:00:00,311.784,1376.8,0,399,2280,66,72,53,73,69.0,6,63.0,20
2007-09-24 00:00:00,695.068,2961.4,1887,76,3939,57,68,56,88,62.5,11,72.0,32
2007-09-24 06:00:00,64.068,312.20000000000005,0,48,0,55,61,77,94,58.0,6,85.5,17
2007-09-24 12:00:00,381.498,1633.0,0,396,3625,55,63,77,94,59.0,8,85.5,17
2007-09-24 18:00:00,414.326,1784.8,0,2631,2694,57,64,68,94,60.5,7,81.0,26
2007-09-25 00:00:00,494.638,2143.4,929,860,1636,50,63,59,82,56.5,13,70.5,23
2007-09-25 06:00:00,96.138,442.0,0,83,504,48,52,76,87,50.0,4,81.5,11
2007-09-25 12:00:00,710.234,3017.2,0,1901,5235,46,59,67,93,52.5,13,80.0,26
2007-09-25 18:00:00,330.68,1387.0,0,179,848,59,63,52,67,61.0,4,59.5,15
2007-09-26 00:00:00,627.29,2651.0,916,90,3233,50,57,72,94,53.5,7,83.0,22
2007-09-26 06:00:00,103.996,439.0,0,132,0,45,48,93,100,46.5,3,96.5,7
2007-09-26 12:00:00,603.9,2539.4,1058,2138,3729,48,57,72,100,52.5,9,86.0,28
2007-09-26 18:00:00,416.212,1792.4,0,4503,551,50,61,63,87,55.5,11,75.0,24
2007-09-27 00:00:00,698.1560000000001,2961.4,0,2642,1381,48,50,82,100,49.0,2,91.0,18
2007-09-27 06:00:00,124.868,538.2,0,215,289,48,48,82,87,48.0,0,84.5,5
2007-09-27 12:00:00,607.21,2550.6,1066,160,4747,48,54,77,87,51.0,6,82.0,10
2007-09-27 18:00:00,149.95,635.0,0,152,773,55,61,59,77,58.0,6,68.0,18
2007-09-28 00:00:00,510.572,2148.2,0,116,1515,48,59,59,88,53.5,11,73.5,29
2007-09-28 06:00:00,138.828,579.6,0,116,578,54,54,82,88,54.0,0,85.0,6
2007-09-28 12:00:00,913.602,3888.4,996,3184,5888,54,57,82,88,55.5,3,85.0,6
2007-09-28 18:00:00,280.38,1197.6,0,268,2343,55,57,88,94,56.0,2,91.0,6
2007-09-29 00:00:00,347.688,1526.0,0,154,1143,54,55,82,88,54.5,1,85.0,6
2007-09-29 06:00:00,107.282,470.2,0,113,0,52,54,88,88,53.0,2,88.0,0
2007-09-29 12:00:00,514.45,2161.8,0,1555,3944,52,55,88,94,53.5,3,91.0,6
2007-09-29 18:00:00,808.192,3441.4,1953,5662,2591,59,63,72,82,61.0,4,77.0,10
2007-09-30 00:00:00,866.598,3708.8,2132,127,1655,52,63,72,88,57.5,11,80.0,16
2007-09-30 06:00:00,109.296,481.6,0,147,0,43,48,87,93,45.5,5,90.0,6
2007-09-30 12:00:00,500.938,2120.6,1405,143,3549,39,61,68,100,50.0,22,84.0,32
2007-09-30 18:00:00,282.726,1194.6,0,148,2487,64,66,52,59,65.0,2,55.5,7
2007-10-01 00:00:00,623.33,2614.8,0,144,4189,50,63,59,82,56.5,13,70.5,23
2007-10-01 06:00:00,113.422,481.0,0,151,210,57,59,77,94,58.0,2,85.5,17
2007-10-01 12:00:00,693.192,2967.8,1081,4226,2412,57,63,82,94,60.0,6,88.0,12
2007-10-01 18:00:00,232.66,1011.0,0,2064,114,64,72,73,88,68.0,8,80.5,15
2007-10-02 00:00:00,681.648,2846.4,426,181,3224,59,68,77,94,63.5,9,85.5,17
2007-10-02 06:00:00,223.968,954.4,508,161,1215,61,63,94,100,62.0,2,97.0,6
2007-10-02 12:00:00,611.5640000000001,2586.6,0,1809,4510,61,64,94,100,62.5,3,97.0,6
2007-10-02 18:00:00,746.982,3177.2,0,4163,5554,68,70,78,88,69.0,2,83.0,10
2007-10-03 00:00:00,616.35,2604.4,0,1889,1536,63,68,88,94,65.5,5,91.0,6
2007-10-03 06:00:00,137.24800000000002,585.6,0,178,493,59,61,94,100,60.0,2,97.0,6
2007-10-03 12:00:00,443.9380000000001,1884.4,979,160,2637,61,64,88,100,62.5,3,94.0,12
2007-10-03 18:00:00,284.154,1228.8,0,2906,0,66,70,78,88,68.0,4,83.0,10
2007-10-04 00:00:00,415.114,1773.1999999999998,0,1780,562,59,66,83,100,62.5,7,91.5,17
2007-10-04 06:00:00,150.596,639.4,0,158,701,59,59,94,100,59.0,0,97.0,6
2007-10-04 12:00:00,544.616,2282.4,0,103,5607,59,61,88,94,60.0,2,91.0,6
2007-10-04 18:00:00,173.146,727.6,0,83,1076,61,63,77,88,62.0,2,82.5,11
2007-10-05 00:00:00,650.1,2765.2,2400,100,2326,52,61,77,94,56.5,9,85.5,17
2007-10-05 06:00:00,137.736,576.0,0,79,576,52,55,94,94,53.5,3,94.0,0
2007-10-05 12:00:00,558.67,2372.4,0,97,4553,52,57,88,94,54.5,5,91.0,6
2007-10-05 18:00:00,283.786,1192.0,0,82,2757,59,64,73,88,61.5,5,80.5,15
2007-10-06 00:00:00,413.9,1748.8,0,93,1539,54,63,72,94,58.5,9,83.0,22
2007-10-06 06:00:00,149.902,627.0,0,91,637,50,55,82,94,52.5,5,88.0,12
2007-10-06 12:00:00,478.016,2020.8,1307,82,3871,48,59,72,93,53.5,11,82.5,21
2007-10-06 18:00:00,406.522,1725.2,1800,97,2113,61,68,56,68,64.5,7,62.0,12
2007-10-07 00:00:00,721.8,3068.4,1733,77,3045,55,63,68,82,59.0,8,75.0,14
2007-10-07 06:00:00,173.892,747.6,0,95,451,45,54,77,93,49.5,9,85.0,16
2007-10-07 12:00:00,297.582,1269.6,163,525,1669,43,59,72,100,51.0,16,86.0,28
2007-10-07 18:00:00,752.704,3172.0,1436,4058,4299,63,68,49,63,65.5,5,56.0,14
2007-10-08 00:00:00,881.9359999999999,3750.2,899,3577,4467,52,63,59,88,57.5,11,73.5,29
2007-10-08 06:00:00,116.058,506.2000000000001,0,151,0,54,54,82,82,54.0,0,82.0,0
2007-10-08 12:00:00,264.312,1121.6,0,94,1256,54,54,82,82,54.0,0,82.0,0
2007-10-08 18:00:00,161.546,700.0,0,80,373,54,54,82,82,54.0,0,82.0,0
2007-10-09 00:00:00,553.326,2325.0,0,95,3453,54,54,82,82,54.0,0,82.0,0
2007-10-09 06:00:00,107.1,472.2000000000001,0,93,0,46,54,87,94,50.0,8,90.5,7
2007-10-09 12:00:00,469.364,1989.2,0,75,4128,52,61,68,94,56.5,9,81.0,26
2007-10-09 18:00:00,516.108,2182.0,752,1883,2920,63,64,56,63,63.5,1,59.5,7
2007-10-10 00:00:00,595.286,2531.2,1282,96,2242,55,63,68,94,59.0,8,81.0,26
2007-10-10 06:00:00,110.38,491.0,0,95,0,46,54,88,94,50.0,8,91.0,6
2007-10-10 12:00:00,315.884,1352.6,943,84,1216,52,57,82,100,54.5,5,91.0,18
2007-10-10 18:00:00,158.79,694.6,0,84,579,59,61,63,77,60.0,2,70.0,14
2007-10-11 00:00:00,581.918,2485.4,920,1854,1550,54,57,77,88,55.5,3,82.5,11
2007-10-11 06:00:00,148.686,641.2,0,150,564,50,55,88,100,52.5,5,94.0,12
2007-10-11 12:00:00,521.462,2194.4,0,95,5204,52,55,82,94,53.5,3,88.0,12
2007-10-11 18:00:00,138.852,601.6,0,75,244,57,61,72,82,59.0,4,77.0,10
2007-10-12 00:00:00,923.446,3919.8,2630,94,1794,50,57,82,88,53.5,7,85.0,6
2007-10-12 06:00:00,149.182,630.8,0,79,511,45,46,93,93,45.5,1,93.0,0
2007-10-12 12:00:00,727.098,3083.2,1020,1386,5454,43,57,82,100,50.0,14,91.0,18
2007-10-12 18:00:00,464.838,2001.0,0,3434,2117,59,63,68,77,61.0,4,72.5,9
2007-10-13 00:00:00,573.386,2445.6,0,129,3577,48,61,77,93,54.5,13,85.0,16
2007-10-13 06:00:00,105.502,473.2,0,77,0,57,57,94,94,57.0,0,94.0,0
2007-10-13 12:00:00,445.026,1882.2,0,95,3981,54,59,77,94,56.5,5,85.5,17
2007-10-13 18:00:00,289.88,1231.8,969,604,671,57,61,72,82,59.0,4,77.0,10
2007-10-14 00:00:00,1086.32,4621.8,0,3023,3811,54,59,72,94,56.5,5,83.0,22
2007-10-14 06:00:00,250.82,1061.4,0,85,656,46,52,87,93,49.0,6,90.0,6
2007-10-14 12:00:00,330.016,1407.4,713,86,2327,46,57,77,93,51.5,11,85.0,16
2007-10-14 18:00:00,827.548,3521.4,2217,5458,2833,61,66,60,68,63.5,5,64.0,8
2007-10-15 00:00:00,652.8679999999999,2763.2,0,1865,1310,54,61,77,94,57.5,7,85.5,17
2007-10-15 06:00:00,134.912,577.4000000000001,0,77,495,46,48,93,100,47.0,2,96.5,7
2007-10-15 12:00:00,533.748,2247.8,0,93,5389,48,59,88,100,53.5,11,94.0,12
2007-10-15 18:00:00,132.986,579.4,0,87,422,57,59,72,88,58.0,2,80.0,16
2007-10-16 00:00:00,464.684,1955.0,1061,82,1348,48,55,77,94,51.5,7,85.5,17
2007-10-16 06:00:00,144.678,625.4,0,77,682,45,46,93,93,45.5,1,93.0,0
2007-10-16 12:00:00,442.87,1869.6,0,645,3705,45,61,77,100,53.0,16,88.5,23
2007-10-16 18:00:00,761.168,3272.4,0,4940,4694,64,70,56,73,67.0,6,64.5,17
2007-10-17 00:00:00,615.726,2618.0,0,2209,795,46,64,64,93,55.0,18,78.5,29
2007-10-17 06:00:00,109.244,477.4,0,191,0,54,55,82,94,54.5,1,88.0,12
2007-10-17 12:00:00,632.158,2668.0,1065,83,5525,55,61,77,94,58.0,6,85.5,17
2007-10-17 18:00:00,254.852,1078.8,0,88,2220,55,61,77,82,58.0,6,79.5,5
2007-10-18 00:00:00,580.676,2453.0,0,91,1223,46,57,76,87,51.5,11,81.5,11
2007-10-18 06:00:00,120.76,509.4,0,72,0,45,50,76,93,47.5,5,84.5,17
2007-10-18 12:00:00,433.786,1825.4,0,88,3930,43,55,63,87,49.0,12,75.0,24
2007-10-18 18:00:00,246.26,1048.0,0,70,1754,55,59,48,58,57.0,4,53.0,10
2007-10-19 00:00:00,717.7239999999999,3001.8,1162,87,4180,46,54,62,87,50.0,8,74.5,25
2007-10-19 06:00:00,154.446,658.6,0,71,821,41,45,87,93,43.0,4,90.0,6
2007-10-19 12:00:00,898.4480000000001,3801.8,1298,1894,5429,41,50,82,93,45.5,9,87.5,11
2007-10-19 18:00:00,514.78,2160.0,1,1071,4828,52,55,58,76,53.5,3,67.0,18
2007-10-20 00:00:00,517.974,2168.2,0,88,570,46,52,67,87,49.0,6,77.0,20
2007-10-20 06:00:00,154.204,658.0,0,69,272,39,45,87,93,42.0,6,90.0,6
2007-10-20 12:00:00,480.47,1993.2,0,86,4466,41,48,66,87,44.5,7,76.5,21
2007-10-20 18:00:00,672.312,2806.6000000000004,2363,68,5222,50,54,41,54,52.0,4,47.5,13
2007-10-21 00:00:00,353.26,1475.4,0,73,3265,43,48,46,82,45.5,5,64.0,36
2007-10-21 06:00:00,146.634,614.6,0,80,0,32,39,75,87,35.5,7,81.0,12
2007-10-21 12:00:00,306.59000000000003,1299.1999999999998,484,556,1650,32,48,62,93,40.0,16,77.5,31
2007-10-21 18:00:00,912.844,3857.0,2256,3635,4809,50,54,41,54,52.0,4,47.5,13
2007-10-22 00:00:00,575.872,2439.6,972,86,854,41,46,62,70,43.5,5,66.0,8
2007-10-22 06:00:00,150.648,666.2,0,69,591,39,48,76,87,43.5,9,81.5,11
2007-10-22 12:00:00,641.064,2682.6,0,85,5848,46,48,62,81,47.0,2,71.5,19
2007-10-22 18:00:00,488.066,2004.8,0,68,6406,48,54,44,62,51.0,6,53.0,18
2007-10-23 00:00:00,373.118,1566.8,0,77,182,41,46,57,76,43.5,5,66.5,19
2007-10-23 06:00:00,152.15200000000002,651.1999999999999,0,75,814,36,41,70,81,38.5,5,75.5,11
2007-10-23 12:00:00,521.498,2169.4,0,66,4293,34,43,66,87,38.5,9,76.5,21
2007-10-23 18:00:00,558.422,2356.8,1067,3296,2141,46,52,54,62,49.0,6,58.0,8
2007-10-24 00:00:00,722.576,3036.6,0,1749,3432,41,48,66,76,44.5,7,71.0,10
2007-10-24 06:00:00,138.884,595.6,0,154,491,37,43,81,87,40.0,6,84.0,6
2007-10-24 12:00:00,534.7760000000001,2238.0,1085,69,4328,37,45,71,87,41.0,8,79.0,16
2007-10-24 18:00:00,250.026,1075.4,1415,68,362,48,50,58,66,49.0,2,62.0,8
2007-10-25 00:00:00,941.95,3972.4,1959,73,3934,43,48,66,81,45.5,5,73.5,15
2007-10-25 06:00:00,122.15,507.4,383,79,0,45,45,76,81,45.0,0,78.5,5
2007-10-25 12:00:00,701.176,2939.4,0,66,5579,45,48,76,81,46.5,3,78.5,5
2007-10-25 18:00:00,175.728,740.4000000000001,0,67,1027,50,50,71,71,50.0,0,71.0,0
2007-10-26 00:00:00,854.864,3608.4,1095,2221,779,45,50,71,82,47.5,5,76.5,11
2007-10-26 06:00:00,196.508,908.0,0,128,90,48,48,82,87,48.0,0,84.5,5
2007-10-26 12:00:00,647.87,2760.8,0,85,5088,48,50,71,82,49.0,2,76.5,11
2007-10-26 18:00:00,178.066,835.6,0,68,0,50,50,71,76,50.0,0,73.5,5
2007-10-27 00:00:00,415.124,1782.4,0,67,588,48,48,76,82,48.0,0,79.0,6
2007-10-27 06:00:00,207.56,954.0,0,84,677,46,48,76,87,47.0,2,81.5,11
2007-10-27 12:00:00,948.882,4057.2,0,4452,3867,46,50,76,87,48.0,4,81.5,11
2007-10-27 18:00:00,525.278,2194.6,1374,236,4405,50,50,71,76,50.0,0,73.5,5
2007-10-28 00:00:00,103.968,439.4,0,84,0,41,50,71,93,45.5,9,82.0,22
2007-10-28 06:00:00,137.91199999999998,574.2,0,67,619,41,43,93,93,42.0,2,93.0,0
2007-10-28 12:00:00,107.974,452.4,0,67,0,43,50,76,93,46.5,7,84.5,17
2007-10-28 18:00:00,152.6,634.0,0,66,962,50,52,67,71,51.0,2,69.0,4
2007-10-29 00:00:00,141.5,593.4,0,100,368,41,50,71,93,45.5,9,82.0,22
2007-10-29 06:00:00,143.928,592.6,0,67,795,46,46,81,81,46.0,0,81.0,0
2007-10-29 12:00:00,152.036,637.0,0,67,986,46,46,81,81,46.0,0,81.0,0
2007-10-29 18:00:00,97.344,407.4,0,67,0,46,46,81,81,46.0,0,81.0,0
2007-10-30 00:00:00,152.12,630.2,0,68,968,46,46,81,81,46.0,0,81.0,0
2007-10-30 06:00:00,95.688,401.4,0,83,0,41,50,87,93,45.5,9,90.0,6
2007-10-30 12:00:00,152.332,632.4,0,66,978,41,52,82,93,46.5,11,87.5,11
2007-10-30 18:00:00,468.09,1955.4,0,1700,3278,52,55,67,77,53.5,3,72.0,10
2007-10-31 00:00:00,94.898,396.8,0,86,0,45,50,76,87,47.5,5,81.5,11
2007-10-31 06:00:00,142.79,592.2,0,69,784,37,45,87,93,41.0,8,90.0,6
2007-10-31 12:00:00,150.702,630.2,0,73,917,36,52,71,100,44.0,16,85.5,29
2007-10-31 18:00:00,739.664,3104.4,0,3778,5387,54,55,54,67,54.5,1,60.5,13
2007-11-01 00:00:00,250.054,1062.2,0,780,1827,39,50,62,93,44.5,11,77.5,31
2007-11-01 06:00:00,96.318,401.6,0,91,0,39,39,93,93,39.0,0,93.0,0
2007-11-01 12:00:00,154.6,641.8,0,67,1013,39,39,93,93,39.0,0,93.0,0
2007-11-01 18:00:00,93.966,393.6,0,68,0,39,39,93,93,39.0,0,93.0,0
2007-11-02 00:00:00,151.332,630.8,0,67,978,39,39,93,93,39.0,0,93.0,0
2007-11-02 06:00:00,150.482,624.8,0,84,915,52,54,82,82,53.0,2,82.0,0
2007-11-02 12:00:00,216.88,919.2,841,186,861,52,54,77,82,53.0,2,79.5,5
2007-11-02 18:00:00,732.546,3066.2,505,1777,6285,54,55,77,82,54.5,1,79.5,5
2007-11-03 00:00:00,343.694,1441.6,0,68,4184,55,55,82,82,55.0,0,82.0,0
2007-11-03 06:00:00,94.38,394.0,0,67,0,54,55,82,100,54.5,1,91.0,18
2007-11-03 12:00:00,153.064,643.0,0,83,975,54,55,94,100,54.5,1,97.0,6
2007-11-03 18:00:00,94.676,398.0,0,66,0,55,57,72,94,56.0,2,83.0,22
2007-11-04 00:00:00,150.43,630.4,0,66,961,54,55,77,82,54.5,1,79.5,5
2007-11-04 06:00:00,96.958,410.2,0,77,0,52,54,82,94,53.0,2,88.0,12
2007-11-04 12:00:00,153.95999999999998,642.8,0,73,951,50,54,82,94,52.0,4,88.0,12
2007-11-04 18:00:00,350.092,1492.6,0,508,1852,52,57,58,72,54.5,5,65.0,14
2007-11-05 00:00:00,884.6759999999999,3767.4,0,3729,4265,48,52,58,71,50.0,4,64.5,13
2007-11-05 06:00:00,121.094,524.6,0,144,126,39,46,76,87,42.5,7,81.5,11
2007-11-05 12:00:00,470.27,1957.4,0,85,4211,41,54,51,87,47.5,13,69.0,36
2007-11-05 18:00:00,275.608,1170.2,1265,84,916,52,54,51,58,53.0,2,54.5,7
2007-11-06 00:00:00,633.62,2678.4,0,84,1330,45,48,71,87,46.5,3,79.0,16
2007-11-06 06:00:00,359.016,1507.8,0,83,624,48,48,82,87,48.0,0,84.5,5
2007-11-06 12:00:00,641.24,2716.0,1105,2026,4364,45,48,76,87,46.5,3,81.5,11
2007-11-06 18:00:00,566.314,2434.8,0,1798,4495,50,54,51,66,52.0,4,58.5,15
2007-11-07 00:00:00,515.808,2197.2000000000003,0,1608,1207,37,50,58,87,43.5,13,72.5,29
2007-11-07 06:00:00,146.358,630.2,0,81,649,36,41,87,93,38.5,5,90.0,6
2007-11-07 12:00:00,434.766,1829.2,0,80,4158,39,48,81,93,43.5,9,87.0,12
2007-11-07 18:00:00,389.004,1699.8,2493,75,0,48,52,76,82,50.0,4,79.0,6
2007-11-08 00:00:00,874.6300000000001,3733.6,2549,65,1567,50,52,76,87,51.0,2,81.5,11
2007-11-08 06:00:00,106.578,463.2,0,81,0,48,50,87,94,49.0,2,90.5,7
2007-11-08 12:00:00,492.792,2090.6,0,79,4355,50,52,88,94,51.0,2,91.0,6
2007-11-08 18:00:00,155.166,690.4,0,81,42,52,55,77,88,53.5,3,82.5,11
2007-11-09 00:00:00,746.524,3142.2000000000003,1715,73,2103,48,52,82,88,50.0,4,85.0,6
2007-11-09 06:00:00,140.182,598.8,0,67,592,45,46,57,87,45.5,1,72.0,30
2007-11-09 12:00:00,517.922,2165.2,0,79,5226,41,46,71,87,43.5,5,79.0,16
2007-11-09 18:00:00,827.0,3515.6,0,4306,6187,46,48,43,50,47.0,2,46.5,7
2007-11-10 00:00:00,686.122,2889.2,0,121,3370,34,45,57,87,39.5,11,72.0,30
2007-11-10 06:00:00,107.602,471.0,0,81,0,37,43,81,87,40.0,6,84.0,6
2007-11-10 12:00:00,645.974,2724.6,1028,81,4922,45,50,76,87,47.5,5,81.5,11
2007-11-10 18:00:00,575.048,2433.2,342,81,3409,54,55,77,82,54.5,1,79.5,5
2007-11-11 00:00:00,1282.976,5469.2,2327,61,5436,52,54,82,88,53.0,2,85.0,6
2007-11-11 06:00:00,459.326,1937.8,1383,79,1560,52,52,82,82,52.0,0,82.0,0
2007-11-11 12:00:00,342.098,1441.6,0,80,1490,50,54,76,87,52.0,4,81.5,11
2007-11-11 18:00:00,368.608,1555.6,0,81,1523,52,55,72,88,53.5,3,80.0,16
2007-11-12 00:00:00,717.092,3043.4,2062,80,1451,46,52,81,88,49.0,6,84.5,7
2007-11-12 06:00:00,146.754,618.1999999999999,0,67,537,43,45,76,87,44.0,2,81.5,11
2007-11-12 12:00:00,673.418,2802.6,1018,71,5374,36,46,71,93,41.0,10,82.0,22
2007-11-12 18:00:00,490.308,2028.4,0,77,6247,46,50,54,66,48.0,4,60.0,12
2007-11-13 00:00:00,845.6659999999999,3582.4,0,3950,1123,32,45,66,93,38.5,13,79.5,27
2007-11-13 06:00:00,153.34,650.4,0,170,685,32,34,93,93,33.0,2,93.0,0
2007-11-13 12:00:00,443.074,1871.4,978,65,2031,34,45,66,93,39.5,11,79.5,27
2007-11-13 18:00:00,900.206,3786.6,0,4616,4126,43,45,71,93,44.0,2,82.0,22
2007-11-14 00:00:00,717.778,2984.6,0,82,4234,45,46,87,93,45.5,1,90.0,6
2007-11-14 06:00:00,122.534,522.8,0,81,220,43,46,81,87,44.5,3,84.0,6
2007-11-14 12:00:00,591.6419999999999,2473.8,0,79,5332,43,45,70,87,44.0,2,78.5,17
2007-11-14 18:00:00,583.394,2427.4,1055,57,6337,43,46,53,61,44.5,3,57.0,8
2007-11-15 00:00:00,750.424,3130.6,0,78,4456,36,43,61,81,39.5,7,71.0,20
2007-11-15 06:00:00,175.382,746.8,0,76,1170,30,34,81,93,32.0,4,87.0,12
2007-11-15 12:00:00,530.996,2212.2,0,57,4774,34,39,61,87,36.5,5,74.0,26
2007-11-15 18:00:00,136.472,627.2,0,77,0,37,41,57,65,39.0,4,61.0,8
2007-11-16 00:00:00,649.138,2744.6,1606,361,1559,32,37,65,81,34.5,5,73.0,16
2007-11-16 06:00:00,105.59,456.6,0,61,0,27,30,86,86,28.5,3,86.0,0
2007-11-16 12:00:00,619.29,2583.6,0,76,5409,27,36,75,86,31.5,9,80.5,11
2007-11-16 18:00:00,942.334,3941.6,1049,4406,6344,36,41,49,61,38.5,5,55.0,12
2007-11-17 00:00:00,642.5400000000001,2692.2000000000003,942,117,1811,27,34,65,93,30.5,7,79.0,28
2007-11-17 06:00:00,142.208,598.0,0,78,634,23,25,86,93,24.0,2,89.5,7
2007-11-17 12:00:00,446.564,1860.8,0,58,4269,23,37,70,93,30.0,14,81.5,23
2007-11-17 18:00:00,773.646,3214.8,1460,593,6359,41,45,53,61,43.0,4,57.0,8
2007-11-18 00:00:00,1247.676,5268.8,1128,1470,3728,28,39,70,93,33.5,11,81.5,23
2007-11-18 06:00:00,389.528,1616.2,1107,87,1510,27,32,93,93,29.5,5,93.0,0
2007-11-18 12:00:00,381.404,1592.6,841,563,1665,30,32,93,100,31.0,2,96.5,7
2007-11-18 18:00:00,491.612,2049.2,773,1390,1285,32,36,81,93,34.0,4,87.0,12
2007-11-19 00:00:00,921.314,3882.6,2480,57,2606,36,37,70,93,36.5,1,81.5,23
2007-11-19 06:00:00,105.09,447.8,0,59,0,36,39,93,93,37.5,3,93.0,0
2007-11-19 12:00:00,527.154,2182.2,0,78,5672,39,45,93,93,42.0,6,93.0,0
2007-11-19 18:00:00,283.448,1179.6,0,58,2385,45,48,87,93,46.5,3,90.0,6
2007-11-20 00:00:00,807.962,3399.4,1089,58,2693,45,46,87,93,45.5,1,90.0,6
2007-11-20 06:00:00,138.086,592.6,0,79,580,45,45,93,93,45.0,0,93.0,0
2007-11-20 12:00:00,767.1859999999999,3210.8,0,2207,5384,45,50,87,93,47.5,5,90.0,6
2007-11-20 18:00:00,468.63,1955.4,0,1542,3466,50,52,82,94,51.0,2,88.0,12
2007-11-21 00:00:00,721.9540000000001,3011.4,1015,126,1596,52,54,77,82,53.0,2,79.5,5
2007-11-21 06:00:00,114.22,486.0,0,80,0,52,55,72,88,53.5,3,80.0,16
2007-11-21 12:00:00,547.5219999999999,2314.6,0,61,3914,50,54,88,94,52.0,4,91.0,6
2007-11-21 18:00:00,274.096,1173.2,0,79,2014,50,55,72,87,52.5,5,79.5,15
2007-11-22 00:00:00,815.998,3386.6,1139,329,3527,43,46,93,93,44.5,3,93.0,0
2007-11-22 06:00:00,103.568,453.8,0,80,0,41,45,93,100,43.0,4,96.5,7
2007-11-22 12:00:00,464.324,1924.8,0,61,4109,39,48,87,100,43.5,9,93.5,13
2007-11-22 18:00:00,356.606,1521.0,0,76,2665,50,55,77,87,52.5,5,82.0,10
2007-11-23 00:00:00,1007.88,4245.4,2867,80,2227,46,50,87,93,48.0,4,90.0,6
2007-11-23 06:00:00,105.564,458.6,0,59,0,45,48,87,93,46.5,3,90.0,6
2007-11-23 12:00:00,664.76,2755.6,0,374,6325,46,46,87,87,46.0,0,87.0,0
2007-11-23 18:00:00,812.516,3420.4,891,3662,5759,45,48,71,87,46.5,3,79.0,16
2007-11-24 00:00:00,939.778,3936.0,1277,2086,1601,39,45,70,81,42.0,6,75.5,11
2007-11-24 06:00:00,262.638,1085.0,461,172,632,34,39,81,87,36.5,5,84.0,6
2007-11-24 12:00:00,594.406,2509.2,0,2589,4145,34,43,76,93,38.5,9,84.5,17
2007-11-24 18:00:00,677.884,2816.4,1112,1290,6384,41,46,57,71,43.5,5,64.0,14
2007-11-25 00:00:00,364.126,1527.6,0,80,2290,34,39,81,87,36.5,5,84.0,6
2007-11-25 06:00:00,105.202,450.8,0,60,0,39,41,76,93,40.0,2,84.5,17
2007-11-25 12:00:00,202.51,876.4000000000001,0,80,787,41,46,93,93,43.5,5,93.0,0
2007-11-25 18:00:00,419.748,1754.2,1000,70,3771,50,50,66,87,50.0,0,76.5,21
2007-11-26 00:00:00,668.138,2803.4,2556,69,1120,39,46,76,93,42.5,7,84.5,17
2007-11-26 06:00:00,143.13,612.0,0,79,653,41,46,81,93,43.5,5,87.0,12
2007-11-26 12:00:00,498.658,2106.4,0,58,4526,45,46,71,87,45.5,1,79.0,16
2007-11-26 18:00:00,283.064,1203.8,0,78,2372,46,50,57,66,48.0,4,61.5,9
2007-11-27 00:00:00,644.864,2703.8,1088,73,1375,37,43,76,93,40.0,6,84.5,17
2007-11-27 06:00:00,139.09,593.4,0,64,566,34,37,93,100,35.5,3,96.5,7
2007-11-27 12:00:00,1060.852,4473.6,834,5126,5968,37,46,76,100,41.5,9,88.0,24
2007-11-27 18:00:00,761.5219999999999,3178.4,229,4098,5588,45,50,54,71,47.5,5,62.5,17
2007-11-28 00:00:00,839.548,3499.6,0,1732,2989,32,41,76,93,36.5,9,84.5,17
2007-11-28 06:00:00,138.296,593.8,0,150,154,28,32,93,100,30.0,4,96.5,7
2007-11-28 12:00:00,658.476,2730.6,1182,59,5482,27,32,93,100,29.5,5,96.5,7
2007-11-28 18:00:00,196.184,826.0,0,79,211,34,36,93,100,35.0,2,96.5,7
2007-11-29 00:00:00,651.984,2726.4,0,481,1963,30,32,93,100,31.0,2,96.5,7
2007-11-29 06:00:00,118.52,508.6,0,80,238,30,34,93,100,32.0,4,96.5,7
2007-11-29 12:00:00,712.1279999999999,2976.4,1080,60,5618,36,39,93,100,37.5,3,96.5,7
2007-11-29 18:00:00,274.798,1148.4,0,73,2097,41,45,93,100,43.0,4,96.5,7
2007-11-30 00:00:00,613.784,2588.2,951,70,865,45,48,87,93,46.5,3,90.0,6
2007-11-30 06:00:00,214.6,954.4,0,61,763,36,41,93,100,38.5,5,96.5,7
2007-11-30 12:00:00,679.036,2816.0,0,238,5937,36,41,93,100,38.5,5,96.5,7
2007-11-30 18:00:00,908.584,3756.8,0,6637,5591,45,48,82,93,46.5,3,87.5,11
2007-12-01 00:00:00,529.508,2203.2,0,1005,1310,46,46,87,87,46.0,0,87.0,0
2007-12-01 06:00:00,156.88,660.2,0,80,658,46,48,87,93,47.0,2,90.0,6
2007-12-01 12:00:00,723.222,3068.4,2698,82,4525,48,50,82,93,49.0,2,87.5,11
2007-12-01 18:00:00,914.544,3835.6,3204,107,6399,48,52,62,76,50.0,4,69.0,14
2007-12-02 00:00:00,1340.296,5671.6,3454,84,6265,46,48,81,93,47.0,2,87.0,12
2007-12-02 06:00:00,605.296,2567.0,0,80,1820,46,48,87,87,47.0,2,87.0,0
2007-12-02 12:00:00,335.254,1421.8,0,81,1806,48,52,87,88,50.0,4,87.5,1
2007-12-02 18:00:00,1262.704,5272.0,2090,6610,5565,52,52,88,88,52.0,0,88.0,0
2007-12-03 00:00:00,742.934,3150.0,0,144,1445,50,54,76,94,52.0,4,85.0,18
2007-12-03 06:00:00,206.436,921.0,0,82,626,48,48,76,82,48.0,0,79.0,6
2007-12-03 12:00:00,624.476,2600.0,1141,77,5881,45,48,82,87,46.5,3,84.5,5
2007-12-03 18:00:00,165.636,715.0,0,61,577,50,52,62,76,51.0,2,69.0,14
2007-12-04 00:00:00,765.512,3202.4,0,79,3344,45,48,76,87,46.5,3,81.5,11
2007-12-04 06:00:00,164.5,693.2,0,78,978,43,46,87,93,44.5,3,90.0,6
2007-12-04 12:00:00,493.978,2074.4,475,427,3359,43,48,82,93,45.5,5,87.5,11
2007-12-04 18:00:00,610.866,2565.2,537,3021,3426,48,50,82,87,49.0,2,84.5,5
2007-12-05 00:00:00,798.292,3372.2,0,2302,798,50,52,87,94,51.0,2,90.5,7
2007-12-05 06:00:00,206.332,919.4,0,79,556,50,50,94,94,50.0,0,94.0,0
2007-12-05 12:00:00,676.6659999999999,2836.4,1461,72,5853,50,54,82,94,52.0,4,88.0,12
2007-12-05 18:00:00,413.696,1737.6,544,66,2840,52,55,77,94,53.5,3,85.5,17
2007-12-06 00:00:00,856.426,3648.0,1417,78,1670,50,54,87,94,52.0,4,90.5,7
2007-12-06 06:00:00,174.752,799.2,0,78,65,48,50,82,87,49.0,2,84.5,5
2007-12-06 12:00:00,760.176,3213.4,1021,80,6275,48,50,87,94,49.0,2,90.5,7
2007-12-06 18:00:00,452.642,1903.8,0,78,3717,50,54,94,100,52.0,4,97.0,6
2007-12-07 00:00:00,1100.364,4650.2,3730,82,1851,54,55,94,100,54.5,1,97.0,6
2007-12-07 06:00:00,191.634,813.2,459,80,691,55,55,94,94,55.0,0,94.0,0
2007-12-07 12:00:00,550.84,2294.8,0,79,5170,52,55,72,94,53.5,3,83.0,22
2007-12-07 18:00:00,729.568,3067.8,0,3470,3803,48,54,67,82,51.0,6,74.5,15
2007-12-08 00:00:00,296.974,1251.6,0,81,599,43,46,81,87,44.5,3,84.0,6
2007-12-08 06:00:00,146.312,629.0,0,79,616,39,45,81,87,42.0,6,84.0,6
2007-12-08 12:00:00,579.956,2445.4,1133,59,4462,39,41,93,93,40.0,2,93.0,0
2007-12-08 18:00:00,515.672,2182.4,0,559,2013,43,43,87,100,43.0,0,93.5,13
2007-12-09 00:00:00,971.464,4114.8,0,1657,5192,45,52,88,100,48.5,7,94.0,12
2007-12-09 06:00:00,135.628,577.2,0,82,0,48,50,82,87,49.0,2,84.5,5
2007-12-09 12:00:00,314.922,1340.4,1065,81,1544,46,46,81,87,46.0,0,84.0,6
2007-12-09 18:00:00,924.788,3881.8,2149,582,4166,46,50,66,87,48.0,4,76.5,21
2007-12-10 00:00:00,899.246,3850.8,962,1683,3018,46,46,87,93,46.0,0,90.0,6
2007-12-10 06:00:00,134.028,558.0,0,80,481,45,46,87,93,45.5,1,90.0,6
2007-12-10 12:00:00,623.76,2614.2,0,59,5345,45,46,76,93,45.5,1,84.5,17
2007-12-10 18:00:00,257.092,1132.0,0,79,486,45,48,76,87,46.5,3,81.5,11
2007-12-11 00:00:00,743.874,3147.2,1102,60,1969,45,46,87,93,45.5,1,90.0,6
2007-12-11 06:00:00,139.312,572.4,0,73,634,43,45,81,81,44.0,2,81.0,0
2007-12-11 12:00:00,546.47,2286.2,0,601,4653,41,43,81,87,42.0,2,84.0,6
2007-12-11 18:00:00,824.592,3493.4,0,3066,4482,39,46,66,87,42.5,7,76.5,21
2007-12-12 00:00:00,794.73,3313.6000000000004,1050,77,2971,37,41,87,93,39.0,4,90.0,6
2007-12-12 06:00:00,99.988,412.6,0,56,0,30,36,93,100,33.0,6,96.5,7
2007-12-12 12:00:00,510.818,2116.0,0,57,4197,30,36,93,100,33.0,6,96.5,7
2007-12-12 18:00:00,346.028,1426.4,1152,76,1078,39,45,76,93,42.0,6,84.5,17
2007-12-13 00:00:00,631.228,2656.2,0,65,2484,34,39,87,93,36.5,5,90.0,6
2007-12-13 06:00:00,131.662,558.8,0,78,442,0,34,93,100,17.0,34,96.5,7
2007-12-13 12:00:00,584.332,2432.4,1103,68,4680,0,39,87,100,19.5,39,93.5,13
2007-12-13 18:00:00,346.388,1492.0,0,63,2141,37,43,76,93,40.0,6,84.5,17
2007-12-14 00:00:00,785.364,3321.0,0,1239,1648,36,37,87,100,36.5,1,93.5,13
2007-12-14 06:00:00,148.8,629.6,0,109,683,32,36,93,100,34.0,4,96.5,7
2007-12-14 12:00:00,570.658,2366.8,0,64,5466,32,34,93,100,33.0,2,96.5,7
2007-12-14 18:00:00,869.544,3638.0,980,3596,6426,32,36,81,93,34.0,4,87.0,12
2007-12-15 00:00:00,385.806,1656.8,0,80,366,34,36,81,81,35.0,2,81.0,0
2007-12-15 06:00:00,178.708,758.0,0,64,944,32,34,75,75,33.0,2,75.0,0
2007-12-15 12:00:00,728.086,3050.0,827,2096,4542,28,34,69,80,31.0,6,74.5,11
2007-12-15 18:00:00,825.6700000000001,3460.6,514,1410,5447,36,37,56,65,36.5,1,60.5,9
2007-12-16 00:00:00,1004.412,4222.6,365,117,3380,30,34,70,80,32.0,4,75.0,10
2007-12-16 06:00:00,454.694,1862.0,0,72,742,27,28,80,86,27.5,1,83.0,6
2007-12-16 12:00:00,585.67,2464.6,891,95,1943,25,30,75,86,27.5,5,80.5,11
2007-12-16 18:00:00,985.192,4100.2,1519,2065,6469,32,36,69,75,34.0,4,72.0,6
2007-12-17 00:00:00,736.662,3082.0,1000,49,3775,30,34,75,86,32.0,4,80.5,11
2007-12-17 06:00:00,109.712,449.2,0,73,170,27,30,80,93,28.5,3,86.5,13
2007-12-17 12:00:00,612.264,2541.6,0,48,6049,30,30,80,80,30.0,0,80.0,0
2007-12-17 18:00:00,255.18,1043.2,0,73,2388,30,32,69,80,31.0,2,74.5,11
2007-12-18 00:00:00,819.91,3433.6,1636,49,1960,30,32,69,75,31.0,2,72.0,6
2007-12-18 06:00:00,137.386,559.2,0,49,641,25,30,74,86,27.5,5,80.0,12
2007-12-18 12:00:00,660.586,2745.6000000000004,1123,693,5321,25,30,75,86,27.5,5,80.5,11
2007-12-18 18:00:00,935.308,3917.2,0,4956,3966,30,34,70,80,32.0,4,75.0,10
2007-12-19 00:00:00,889.914,3725.0,0,112,1165,27,30,75,86,28.5,3,80.5,11
2007-12-19 06:00:00,150.482,616.8000000000001,0,49,471,25,27,86,93,26.0,2,89.5,7
2007-12-19 12:00:00,633.388,2616.6,0,47,5792,23,27,80,93,25.0,4,86.5,13
2007-12-19 18:00:00,564.396,2317.4,1233,73,3960,28,34,70,80,31.0,6,75.0,10
2007-12-20 00:00:00,847.7860000000001,3570.8,0,2489,1456,27,30,80,86,28.5,3,83.0,6
2007-12-20 06:00:00,144.462,603.6,0,130,0,23,27,86,93,25.0,4,89.5,7
2007-12-20 12:00:00,502.15,2069.8,0,28,4894,19,28,80,100,23.5,9,90.0,20
2007-12-20 18:00:00,683.75,2820.4,1149,70,6520,30,37,65,80,33.5,7,72.5,15
2007-12-21 00:00:00,619.396,2589.4,710,48,2178,27,34,75,86,30.5,7,80.5,11
2007-12-21 06:00:00,143.708,591.2,0,49,655,23,27,86,93,25.0,4,89.5,7
2007-12-21 12:00:00,649.904,2701.0,1191,48,5559,23,32,75,93,27.5,9,84.0,18
2007-12-21 18:00:00,525.624,2171.6,0,50,4321,36,41,56,70,38.5,5,63.0,14
2007-12-22 00:00:00,663.34,2764.0,0,53,1716,25,34,70,93,29.5,9,81.5,23
2007-12-22 06:00:00,173.28,702.8,0,54,593,23,25,93,100,24.0,2,96.5,7
2007-12-22 12:00:00,534.168,2221.8,0,488,4334,21,32,87,100,26.5,11,93.5,13
2007-12-22 18:00:00,760.1859999999999,3170.0,1268,2426,5555,37,48,50,70,42.5,11,60.0,20
2007-12-23 00:00:00,1143.63,4840.0,2551,1582,2191,30,37,75,87,33.5,7,81.0,12
2007-12-23 06:00:00,286.81600000000003,1162.2,100,53,557,30,30,86,86,30.0,0,86.0,0
2007-12-23 12:00:00,493.6,2037.8,0,53,4285,30,30,86,86,30.0,0,86.0,0
2007-12-23 18:00:00,513.106,2146.6,1107,534,2139,30,30,86,86,30.0,0,86.0,0
2007-12-24 00:00:00,1115.526,4708.599999999999,764,2451,4981,30,30,86,86,30.0,0,86.0,0
2007-12-24 06:00:00,227.796,947.4,0,114,1971,25,27,93,100,26.0,2,96.5,7
2007-12-24 12:00:00,613.27,2578.0,1177,2073,1916,23,30,93,100,26.5,7,96.5,7
2007-12-24 18:00:00,925.362,3865.4,1808,77,5658,36,43,61,81,39.5,7,71.0,20
2007-12-25 00:00:00,491.42,2040.8,0,52,4805,32,34,81,87,33.0,2,84.0,6
2007-12-25 06:00:00,161.04,672.2,0,53,0,30,32,80,93,31.0,2,86.5,13
2007-12-25 12:00:00,511.988,2123.6000000000004,1097,703,1999,30,34,75,86,32.0,4,80.5,11
2007-12-25 18:00:00,926.518,3856.0,1721,2556,4417,37,39,70,75,38.0,2,72.5,5
2007-12-26 00:00:00,1095.422,4567.2,1770,56,2668,37,39,75,81,38.0,2,78.0,6
2007-12-26 06:00:00,471.618,1905.2,0,83,310,36,37,87,93,36.5,1,90.0,6
2007-12-26 12:00:00,710.196,2957.4,0,55,1120,34,36,93,100,35.0,2,96.5,7
2007-12-26 18:00:00,1055.134,4391.0,1109,2563,6451,37,39,93,100,38.0,2,96.5,7
2007-12-27 00:00:00,343.332,1440.0,0,72,1599,37,39,93,100,38.0,2,96.5,7
2007-12-27 06:00:00,150.15,630.8,0,57,669,37,39,93,100,38.0,2,96.5,7
2007-12-27 12:00:00,465.114,1944.4,0,56,1100,39,39,93,100,39.0,0,96.5,7
2007-12-27 18:00:00,741.184,3052.8,0,85,3874,41,45,93,100,43.0,4,96.5,7
2007-12-28 00:00:00,1175.75,5022.0,4122,1292,2317,43,45,93,100,44.0,2,96.5,7
2007-12-28 06:00:00,122.554,543.0,0,144,0,41,43,93,100,42.0,2,96.5,7
2007-12-28 12:00:00,448.604,1877.8,0,56,3009,41,41,93,100,41.0,0,96.5,7
2007-12-28 18:00:00,1349.422,5610.8,1162,6663,6476,41,45,93,100,43.0,4,96.5,7
2007-12-29 00:00:00,1192.472,4972.4,818,1691,6338,41,45,87,93,43.0,4,90.0,6
2007-12-29 06:00:00,840.9,3436.4,0,80,4256,41,43,93,93,42.0,2,93.0,0
2007-12-29 12:00:00,675.478,2834.4,0,2171,1514,43,45,93,93,44.0,2,93.0,0
2007-12-29 18:00:00,735.026,3058.2,2155,126,5438,46,48,81,93,47.0,2,87.0,12
2007-12-30 00:00:00,1047.552,4437.4,2681,57,3698,41,46,81,87,43.5,5,84.0,6
2007-12-30 06:00:00,169.61,706.4,0,81,188,39,41,81,93,40.0,2,87.0,12
2007-12-30 12:00:00,353.45000000000005,1478.0,0,883,2083,36,43,93,100,39.5,7,96.5,7
2007-12-30 18:00:00,973.818,4064.8,1071,2574,5954,45,48,82,87,46.5,3,84.5,5
2007-12-31 00:00:00,1062.038,4501.4,2524,59,5260,41,45,93,93,43.0,4,93.0,0
2007-12-31 06:00:00,109.62,473.8,0,80,0,39,41,93,100,40.0,2,96.5,7
2007-12-31 12:00:00,493.75,2075.2,0,1672,1392,39,41,93,100,40.0,2,96.5,7
2007-12-31 18:00:00,821.076,3428.2,0,1620,6418,41,43,93,93,42.0,2,93.0,0
2008-01-01 00:00:00,792.096,3318.0,0,85,6261,41,43,93,100,42.0,2,96.5,7
2008-01-01 06:00:00,799.9300000000001,3292.8,0,57,6437,41,41,93,100,41.0,0,96.5,7
2008-01-01 12:00:00,521.172,2157.6,542,479,1156,39,41,93,100,40.0,2,96.5,7
2008-01-01 18:00:00,647.366,2708.2,582,2147,2376,39,43,81,100,41.0,4,90.5,19
2008-01-02 00:00:00,791.27,3330.6,1337,56,2386,0,37,93,100,18.5,37,96.5,7
2008-01-02 06:00:00,159.522,681.1999999999999,0,83,521,32,34,87,100,33.0,2,93.5,13
2008-01-02 12:00:00,573.466,2382.4,0,56,4882,32,32,80,87,32.0,0,83.5,7
2008-01-02 18:00:00,307.506,1287.0,0,55,2755,32,36,75,81,34.0,4,78.0,6
2008-01-03 00:00:00,603.612,2518.8,0,2900,829,30,32,75,80,31.0,2,77.5,5
2008-01-03 06:00:00,180.206,766.4,0,167,760,28,30,80,86,29.0,2,83.0,6
2008-01-03 12:00:00,408.658,1706.8,0,70,2319,30,34,93,100,32.0,4,96.5,7
2008-01-03 18:00:00,359.028,1498.8000000000002,0,60,1175,36,39,93,100,37.5,3,96.5,7
2008-01-04 00:00:00,562.216,2366.4,1130,549,2417,37,39,87,93,38.0,2,90.0,6
2008-01-04 06:00:00,139.166,586.6,0,60,550,39,41,87,93,40.0,2,90.0,6
2008-01-04 12:00:00,727.966,3067.0,0,1640,5126,43,45,87,93,44.0,2,90.0,6
2008-01-04 18:00:00,769.678,3253.4,0,3470,3952,48,50,71,82,49.0,2,76.5,11
2008-01-05 00:00:00,655.042,2762.8,1241,156,2124,48,48,82,93,48.0,0,87.5,11
2008-01-05 06:00:00,140.696,594.8,0,86,494,46,48,87,93,47.0,2,90.0,6
2008-01-05 12:00:00,422.158,1790.0,0,56,3202,43,46,87,100,44.5,3,93.5,13
2008-01-05 18:00:00,730.3100000000001,3109.2,1105,79,4875,48,48,82,87,48.0,0,84.5,5
2008-01-06 00:00:00,890.0840000000001,3789.4,1008,65,6020,46,48,87,93,47.0,2,90.0,6
2008-01-06 06:00:00,205.81,862.0,0,57,1554,43,46,93,93,44.5,3,93.0,0
2008-01-06 12:00:00,274.404,1165.2,0,85,1668,39,45,87,100,42.0,6,93.5,13
2008-01-06 18:00:00,576.2180000000001,2430.2,1182,1973,2734,45,48,76,93,46.5,3,84.5,17
2008-01-07 00:00:00,768.752,3304.4,784,330,1868,45,48,93,93,46.5,3,93.0,0
2008-01-07 06:00:00,145.15,604.2,0,85,541,48,54,82,100,51.0,6,91.0,18
2008-01-07 12:00:00,653.336,2718.0,1288,57,5345,46,48,76,93,47.0,2,84.5,17
2008-01-07 18:00:00,193.33,804.4,0,84,1285,48,52,62,71,50.0,4,66.5,9
2008-01-08 00:00:00,703.9979999999999,2951.4,0,56,3123,45,46,76,81,45.5,1,78.5,5
2008-01-08 06:00:00,162.95,693.0,0,85,995,41,45,81,93,43.0,4,87.0,12
2008-01-08 12:00:00,409.398,1738.4,61,482,1638,39,43,93,100,41.0,4,96.5,7
2008-01-08 18:00:00,787.902,3298.6000000000004,964,2858,5715,41,41,93,100,41.0,0,96.5,7
2008-01-09 00:00:00,683.3,2895.6,1172,86,1445,41,43,93,93,42.0,2,93.0,0
2008-01-09 06:00:00,153.994,665.4,0,64,516,43,45,81,93,44.0,2,87.0,12
2008-01-09 12:00:00,614.842,2561.2,0,78,5373,45,46,93,100,45.5,1,96.5,7
2008-01-09 18:00:00,279.05,1178.2,1162,58,1377,46,50,71,87,48.0,4,79.0,16
2008-01-10 00:00:00,740.5540000000001,3129.2,0,84,1697,41,45,76,93,43.0,4,84.5,17
2008-01-10 06:00:00,204.348,903.8,0,57,656,37,41,87,100,39.0,4,93.5,13
2008-01-10 12:00:00,619.6460000000001,2614.6,0,85,4993,37,46,93,100,41.5,9,96.5,7
2008-01-10 18:00:00,401.864,1684.8,0,57,3109,48,52,82,93,50.0,4,87.5,11
2008-01-11 00:00:00,668.218,2853.0,1307,86,1234,50,52,82,87,51.0,2,84.5,5
2008-01-11 06:00:00,147.748,631.2,0,57,733,50,50,82,82,50.0,0,82.0,0
2008-01-11 12:00:00,512.516,2141.6,0,87,4247,48,52,67,87,50.0,4,77.0,20
2008-01-11 18:00:00,383.78,1591.8000000000002,0,59,1836,46,52,76,93,49.0,6,84.5,17
2008-01-12 00:00:00,661.774,2782.8,1261,87,1181,46,46,81,87,46.0,0,84.0,6
2008-01-12 06:00:00,179.78,814.2,1,59,0,43,45,76,81,44.0,2,78.5,5
2008-01-12 12:00:00,655.954,2787.8,2135,526,2842,39,43,76,87,41.0,4,81.5,11
2008-01-12 18:00:00,587.636,2513.0,1152,1957,2424,45,48,62,76,46.5,3,69.0,14
2008-01-13 00:00:00,1448.038,6159.4,2306,79,5850,41,45,76,81,43.0,4,78.5,5
2008-01-13 06:00:00,1043.62,4319.8,1662,69,4965,41,43,81,87,42.0,2,84.0,6
2008-01-13 12:00:00,455.894,1910.4,959,69,866,41,45,81,93,43.0,4,87.0,12
2008-01-13 18:00:00,546.47,2364.6,2937,99,970,45,48,66,81,46.5,3,73.5,15
2008-01-14 00:00:00,835.672,3563.8,947,103,2561,41,43,66,70,42.0,2,68.0,4
2008-01-14 06:00:00,140.212,596.2,0,91,583,41,43,66,81,42.0,2,73.5,15
2008-01-14 12:00:00,611.16,2573.6,0,52,5212,43,46,76,87,44.5,3,81.5,11
2008-01-14 18:00:00,321.882,1387.8,0,88,2404,46,50,76,93,48.0,4,84.5,17
2008-01-15 00:00:00,951.678,4103.4,5918,108,1539,46,48,82,87,47.0,2,84.5,5
2008-01-15 06:00:00,167.43,766.0,0,96,340,46,46,87,87,46.0,0,87.0,0
2008-01-15 12:00:00,691.318,2904.2,0,1043,5506,46,48,82,87,47.0,2,84.5,5
2008-01-15 18:00:00,1099.006,4616.2,782,5615,6347,46,48,82,87,47.0,2,84.5,5
2008-01-16 00:00:00,729.158,3077.0,0,129,2319,46,48,82,87,47.0,2,84.5,5
2008-01-16 06:00:00,166.812,759.6,0,109,0,43,48,82,93,45.5,5,87.5,11
2008-01-16 12:00:00,640.63,2699.6,0,408,5489,43,45,87,93,44.0,2,90.0,6
2008-01-16 18:00:00,638.354,2703.2,1162,2860,2640,46,48,76,93,47.0,2,84.5,17
2008-01-17 00:00:00,690.0559999999999,2937.8,0,53,1262,41,45,93,93,43.0,4,93.0,0
2008-01-17 06:00:00,146.572,646.0,0,97,156,43,45,87,93,44.0,2,90.0,6
2008-01-17 12:00:00,617.746,2597.8,1007,94,4944,43,45,87,93,44.0,2,90.0,6
2008-01-17 18:00:00,289.194,1231.2,0,107,1980,45,48,87,93,46.5,3,90.0,6
2008-01-18 00:00:00,518.77,2213.8,0,52,1577,50,52,88,100,51.0,2,94.0,12
2008-01-18 06:00:00,182.554,808.5999999999999,0,103,688,48,52,82,88,50.0,4,85.0,6
2008-01-18 12:00:00,696.014,2940.8,1034,93,4828,45,48,87,93,46.5,3,90.0,6
2008-01-18 18:00:00,528.9159999999999,2199.4,0,86,5958,48,52,93,100,50.0,4,96.5,7
2008-01-19 00:00:00,779.504,3313.6,0,564,3509,54,55,88,94,54.5,1,91.0,6
2008-01-19 06:00:00,115.708,500.2,0,90,0,54,54,88,88,54.0,0,88.0,0
2008-01-19 12:00:00,501.74,2126.0,0,3674,1505,52,55,82,94,53.5,3,88.0,12
2008-01-19 18:00:00,699.444,2970.6,2521,2191,2661,57,59,72,77,58.0,2,74.5,5
2008-01-20 00:00:00,663.414,2796.8,0,99,3849,54,55,77,82,54.5,1,79.5,5
2008-01-20 06:00:00,180.778,763.4,0,110,612,52,54,77,82,53.0,2,79.5,5
2008-01-20 12:00:00,274.482,1177.6,762,87,1317,52,54,72,82,53.0,2,77.0,10
2008-01-20 18:00:00,561.9359999999999,2391.6000000000004,0,98,2273,54,55,67,72,54.5,1,69.5,5
2008-01-21 00:00:00,723.172,3081.8,1013,85,738,52,54,67,76,53.0,2,71.5,9
2008-01-21 06:00:00,175.48000000000002,795.6,0,97,543,50,50,76,82,50.0,0,79.0,6
2008-01-21 12:00:00,610.336,2581.8,0,94,5709,48,50,71,76,49.0,2,73.5,5
2008-01-21 18:00:00,362.108,1544.0,0,92,3137,50,52,67,82,51.0,2,74.5,15
2008-01-22 00:00:00,711.0740000000001,3026.0,0,93,1058,50,52,82,88,51.0,2,85.0,6
2008-01-22 06:00:00,186.21,807.0,0,108,726,48,54,76,94,51.0,6,85.0,18
2008-01-22 12:00:00,438.27,1891.6,1159,94,1376,46,48,66,76,47.0,2,71.0,10
2008-01-22 18:00:00,951.3,4048.8,1699,4776,4828,45,48,57,66,46.5,3,61.5,9
2008-01-23 00:00:00,749.238,3230.0,1812,2662,622,34,41,70,93,37.5,7,81.5,23
2008-01-23 06:00:00,151.15,707.8,0,134,0,34,37,87,93,35.5,3,90.0,6
2008-01-23 12:00:00,645.0,2701.4,0,81,5719,37,43,81,93,40.0,6,87.0,12
2008-01-23 18:00:00,556.3580000000001,2298.6,1116,82,5715,45,52,71,76,48.5,7,73.5,5
2008-01-24 00:00:00,529.8,2241.4,0,90,1925,46,48,81,87,47.0,2,84.0,6
2008-01-24 06:00:00,132.92000000000002,575.8,0,80,499,43,45,76,87,44.0,2,81.5,11
2008-01-24 12:00:00,518.82,2194.6,0,80,4024,43,45,71,81,44.0,2,76.0,10
2008-01-24 18:00:00,166.04,763.0,0,82,0,46,50,76,87,48.0,4,81.5,11
2008-01-25 00:00:00,827.242,3505.2,1107,78,1412,45,48,76,87,46.5,3,81.5,11
2008-01-25 06:00:00,293.386,1242.8,0,75,671,34,43,87,100,38.5,9,93.5,13
2008-01-25 12:00:00,605.354,2550.0,0,77,4923,30,41,93,100,35.5,11,96.5,7
2008-01-25 18:00:00,639.98,2686.4,0,2194,5239,46,50,58,76,48.0,4,67.0,18
2008-01-26 00:00:00,701.136,2944.2,0,75,576,34,41,76,93,37.5,7,84.5,17
2008-01-26 06:00:00,175.598,776.4,0,74,0,30,34,93,100,32.0,4,96.5,7
2008-01-26 12:00:00,579.058,2436.8,1105,55,4509,28,34,93,100,31.0,6,96.5,7
2008-01-26 18:00:00,637.184,2678.0,0,93,5476,41,48,62,93,44.5,7,77.5,31
2008-01-27 00:00:00,1443.148,6156.8,3820,89,5621,32,41,76,93,36.5,9,84.5,17
2008-01-27 06:00:00,286.118,1186.0,0,58,830,28,30,93,93,29.0,2,93.0,0
2008-01-27 12:00:00,394.51,1653.6,0,498,2023,25,36,87,100,30.5,11,93.5,13
2008-01-27 18:00:00,611.636,2582.4,0,2795,2948,41,52,38,70,46.5,11,54.0,32
2008-01-28 00:00:00,1089.502,4636.2,3725,467,1566,32,43,49,93,37.5,11,71.0,44
2008-01-28 06:00:00,277.668,1177.0,0,56,534,27,30,86,93,28.5,3,89.5,7
2008-01-28 12:00:00,782.662,3318.2,0,75,4867,34,39,93,100,36.5,5,96.5,7
2008-01-28 18:00:00,459.85,1922.8,0,75,4671,41,46,71,87,43.5,5,79.0,16
2008-01-29 00:00:00,788.016,3330.2000000000003,1142,74,2720,32,39,87,100,35.5,7,93.5,13
2008-01-29 06:00:00,380.464,1588.8,0,37,1496,34,36,93,100,35.0,2,96.5,7
2008-01-29 12:00:00,562.69,2364.2,0,74,3584,34,36,93,93,35.0,2,93.0,0
2008-01-29 18:00:00,1037.56,4400.4,1454,5963,5377,37,41,81,87,39.0,4,84.0,6
2008-01-30 00:00:00,695.3100000000001,2939.4,33,125,620,37,39,87,87,38.0,2,87.0,0
2008-01-30 06:00:00,442.116,1852.0,0,76,653,36,36,87,93,36.0,0,90.0,6
2008-01-30 12:00:00,596.7719999999999,2506.6,0,75,5233,36,37,93,100,36.5,1,96.5,7
2008-01-30 18:00:00,149.686,667.4,0,37,0,37,41,87,100,39.0,4,93.5,13
2008-01-31 00:00:00,452.072,1924.0,0,73,1375,30,41,87,100,35.5,11,93.5,13
2008-01-31 06:00:00,162.606,729.8,0,74,281,28,30,93,100,29.0,2,96.5,7
2008-01-31 12:00:00,514.62,2180.6,0,38,4389,30,36,87,93,33.0,6,90.0,6
2008-01-31 18:00:00,214.146,969.2,0,76,88,37,43,76,81,40.0,6,78.5,5
2008-02-01 00:00:00,1062.55,4462.8,1165,79,4679,43,43,81,93,43.0,0,87.0,12
2008-02-01 06:00:00,294.898,1256.6,0,45,1277,45,46,93,100,45.5,1,96.5,7
2008-02-01 12:00:00,436.888,1893.2,0,76,1707,45,45,93,93,45.0,0,93.0,0
2008-02-01 18:00:00,440.82,1845.0,0,79,3726,39,43,87,93,41.0,4,90.0,6
2008-02-02 00:00:00,362.046,1510.6,336,80,531,37,39,93,100,38.0,2,96.5,7
2008-02-02 06:00:00,169.506,708.6,811,38,285,32,37,93,93,34.5,5,93.0,0
2008-02-02 12:00:00,495.966,2071.4,0,76,3931,28,39,81,93,33.5,11,87.0,12
2008-02-02 18:00:00,762.096,3222.2,2128,634,4842,41,45,57,76,43.0,4,66.5,19
2008-02-03 00:00:00,1508.466,6444.400000000001,3308,2016,6130,34,39,70,93,36.5,5,81.5,23
2008-02-03 06:00:00,425.016,1771.4,1149,84,3263,28,32,93,100,30.0,4,96.5,7
2008-02-03 12:00:00,267.838,1143.8,0,77,1456,28,34,75,93,31.0,6,84.0,18
2008-02-03 18:00:00,660.564,2793.8,1170,4190,2108,37,46,57,70,41.5,9,63.5,13
2008-02-04 00:00:00,731.15,3126.4,0,84,1625,45,48,57,66,46.5,3,61.5,9
2008-02-04 06:00:00,134.712,574.0,0,54,554,45,46,81,93,45.5,1,87.0,12
2008-02-04 12:00:00,650.194,2748.4,1161,82,5058,43,45,81,93,44.0,2,87.0,12
2008-02-04 18:00:00,279.114,1167.0,0,78,2560,43,46,76,87,44.5,3,81.5,11
2008-02-05 00:00:00,564.1179999999999,2389.8,0,38,1359,39,43,76,87,41.0,4,81.5,11
2008-02-05 06:00:00,128.308,546.0,0,78,425,39,41,81,93,40.0,2,87.0,12
2008-02-05 12:00:00,629.7280000000001,2637.0,1098,362,4715,43,48,82,93,45.5,5,87.5,11
2008-02-05 18:00:00,905.614,3776.2,0,3982,6358,48,52,82,94,50.0,4,88.0,12
2008-02-06 00:00:00,808.806,3424.0,0,3381,2219,52,52,94,94,52.0,0,94.0,0
2008-02-06 06:00:00,107.156,462.6,0,119,0,52,52,82,88,52.0,0,85.0,6
2008-02-06 12:00:00,605.0260000000001,2589.0,1090,82,5251,46,52,67,93,49.0,6,80.0,26
2008-02-06 18:00:00,170.3,749.0,0,80,718,52,55,51,67,53.5,3,59.0,16
2008-02-07 00:00:00,787.058,3303.8,1024,75,2459,37,48,66,93,42.5,11,79.5,27
2008-02-07 06:00:00,103.38,445.0,0,73,0,32,36,93,93,34.0,4,93.0,0
2008-02-07 12:00:00,576.04,2395.2,0,73,5730,30,43,87,100,36.5,13,93.5,13
2008-02-07 18:00:00,174.486,754.2,0,76,748,48,54,54,76,51.0,6,65.0,22
2008-02-08 00:00:00,664.404,2798.2,0,73,1611,41,48,66,87,44.5,7,76.5,21
2008-02-08 06:00:00,166.11,698.4,0,65,694,36,39,87,93,37.5,3,90.0,6
2008-02-08 12:00:00,493.018,2087.8,0,44,4170,34,43,76,93,38.5,9,84.5,17
2008-02-08 18:00:00,662.9399999999999,2825.6,940,1739,4130,48,54,44,57,51.0,6,50.5,13
2008-02-09 00:00:00,628.496,2664.2,0,73,569,39,50,54,81,44.5,11,67.5,27
2008-02-09 06:00:00,136.3,559.6,0,73,41,32,39,75,87,35.5,7,81.0,12
2008-02-09 12:00:00,544.0640000000001,2274.8,0,657,3554,34,45,53,81,39.5,11,67.0,28
2008-02-09 18:00:00,580.452,2399.6,836,131,5050,48,55,41,46,51.5,7,43.5,5
2008-02-10 00:00:00,841.46,3535.6,1214,1977,1648,41,50,54,65,45.5,9,59.5,11
2008-02-10 06:00:00,151.496,638.8,0,71,579,32,41,65,80,36.5,9,72.5,15
2008-02-10 12:00:00,300.16,1270.4,0,649,1061,30,43,57,86,36.5,13,71.5,29
2008-02-10 18:00:00,642.11,2691.0,1068,2142,2224,46,54,44,54,50.0,8,49.0,10
2008-02-11 00:00:00,1090.948,4611.2,1494,93,6264,41,48,57,76,44.5,7,66.5,19
2008-02-11 06:00:00,118.858,518.0,0,73,56,37,41,75,81,39.0,4,78.0,6
2008-02-11 12:00:00,663.702,2756.6,1018,73,5744,36,45,66,87,40.5,9,76.5,21
2008-02-11 18:00:00,175.208,742.0,0,76,1157,48,54,41,62,51.0,6,51.5,21
2008-02-12 00:00:00,734.2479999999999,3085.2,0,75,1973,43,50,50,76,46.5,7,63.0,26
2008-02-12 06:00:00,141.35399999999998,601.2,0,45,638,34,43,66,81,38.5,9,73.5,15
2008-02-12 12:00:00,699.598,2970.6,1036,64,4578,32,45,66,93,38.5,13,79.5,27
2008-02-12 18:00:00,759.68,3217.2000000000003,973,1671,6050,48,54,44,58,51.0,6,51.0,14
2008-02-13 00:00:00,387.166,1630.8,0,76,872,39,48,62,93,43.5,9,77.5,31
2008-02-13 06:00:00,149.98399999999998,633.2,0,76,615,37,39,87,93,38.0,2,90.0,6
2008-02-13 12:00:00,575.866,2411.4,1393,74,4736,34,45,71,93,39.5,11,82.0,22
2008-02-13 18:00:00,355.474,1506.4,1137,3000,0,48,52,54,71,50.0,4,62.5,17
2008-02-14 00:00:00,819.174,3484.4,0,465,2217,39,48,57,81,43.5,9,69.0,24
2008-02-14 06:00:00,138.006,584.5999999999999,0,73,421,32,37,81,93,34.5,5,87.0,12
2008-02-14 12:00:00,687.028,2882.2,1300,73,5626,32,37,87,93,34.5,5,90.0,6
2008-02-14 18:00:00,248.478,1055.2,0,73,2046,41,45,71,76,43.0,4,73.5,5
2008-02-15 00:00:00,531.11,2222.6,0,72,1206,34,37,87,100,35.5,3,93.5,13
2008-02-15 06:00:00,144.804,588.4,0,38,787,32,34,93,100,33.0,2,96.5,7
2008-02-15 12:00:00,670.66,2789.6,0,71,5419,32,34,93,100,33.0,2,96.5,7
2008-02-15 18:00:00,577.492,2374.6,0,1504,5987,34,36,81,93,35.0,2,87.0,12
2008-02-16 00:00:00,612.252,2572.4,1109,110,1224,32,36,81,87,34.0,4,84.0,6
2008-02-16 06:00:00,173.474,740.0,0,74,690,28,32,80,86,30.0,4,83.0,6
2008-02-16 12:00:00,423.1,1784.2,0,636,3027,27,36,60,86,31.5,9,73.0,26
2008-02-16 18:00:00,630.778,2667.6,1076,1539,2356,37,45,39,56,41.0,8,47.5,17
2008-02-17 00:00:00,1119.596,4735.4,0,111,5526,34,41,44,48,37.5,7,46.0,4
2008-02-17 06:00:00,225.146,916.6,0,72,0,28,34,52,64,31.0,6,58.0,12
2008-02-17 12:00:00,382.378,1611.6,1089,37,1876,28,37,48,64,32.5,9,56.0,16
2008-02-17 18:00:00,568.162,2397.4,1019,2055,2909,39,46,42,50,42.5,7,46.0,8
2008-02-18 00:00:00,757.682,3216.8,1074,93,1264,32,43,57,70,37.5,11,63.5,13
2008-02-18 06:00:00,139.83,589.8,0,71,518,25,32,64,93,28.5,7,78.5,29
2008-02-18 12:00:00,569.96,2351.0,0,37,5674,25,37,75,93,31.0,12,84.0,18
2008-02-18 18:00:00,253.846,1052.2,0,73,2511,45,52,50,66,48.5,7,58.0,16
2008-02-19 00:00:00,550.768,2308.8,0,70,1642,39,48,54,75,43.5,9,64.5,21
2008-02-19 06:00:00,155.62,648.6,0,39,719,34,39,65,75,36.5,5,70.0,10
2008-02-19 12:00:00,824.368,3487.0,1881,2469,4495,32,37,60,69,34.5,5,64.5,9
2008-02-19 18:00:00,581.842,2431.8,0,2104,4577,46,52,50,54,49.0,6,52.0,4
2008-02-20 00:00:00,565.086,2389.0,0,99,1409,39,48,62,87,43.5,9,74.5,25
2008-02-20 06:00:00,149.01,623.8,0,77,717,43,43,81,93,43.0,0,87.0,12
2008-02-20 12:00:00,596.09,2487.0,1020,78,4344,43,46,93,100,44.5,3,96.5,7
2008-02-20 18:00:00,382.892,1619.1999999999998,0,3182,0,46,48,93,100,47.0,2,96.5,7
2008-02-21 00:00:00,1125.798,4786.0,2635,2179,2643,48,48,93,93,48.0,0,93.0,0
2008-02-21 06:00:00,130.602,565.2,0,78,0,46,48,93,93,47.0,2,93.0,0
2008-02-21 12:00:00,637.686,2667.4,0,76,5774,41,46,87,93,43.5,5,90.0,6
2008-02-21 18:00:00,192.834,834.4,0,77,1000,46,50,76,87,48.0,4,81.5,11
2008-02-22 00:00:00,672.728,2828.4,0,76,1749,46,50,87,93,48.0,4,90.0,6
2008-02-22 06:00:00,147.45600000000002,624.8,0,75,658,45,46,93,100,45.5,1,96.5,7
2008-02-22 12:00:00,657.5,2771.6,1167,77,4617,45,50,93,94,47.5,5,93.5,1
2008-02-22 18:00:00,502.036,2108.2,0,1717,3960,54,55,72,82,54.5,1,77.0,10
2008-02-23 00:00:00,425.572,1775.0,0,116,866,48,54,67,82,51.0,6,74.5,15
2008-02-23 06:00:00,143.64600000000002,614.4,0,79,668,46,48,82,87,47.0,2,84.5,5
2008-02-23 12:00:00,267.36,1148.2,0,499,820,46,50,82,93,48.0,4,87.5,11
2008-02-23 18:00:00,539.75,2286.0,1110,1594,2342,52,55,67,76,53.5,3,71.5,9
2008-02-24 00:00:00,883.2139999999999,3733.2,574,78,6210,39,52,76,100,45.5,13,88.0,24
2008-02-24 06:00:00,494.468,2023.2,0,77,6498,34,39,93,100,36.5,5,96.5,7
2008-02-24 12:00:00,524.22,2186.4,754,91,4193,37,41,93,100,39.0,4,96.5,7
2008-02-24 18:00:00,100.846,425.8,0,83,0,46,63,55,93,54.5,17,74.0,38
2008-02-25 00:00:00,143.474,604.6,0,81,756,55,59,59,72,57.0,4,65.5,13
2008-02-25 06:00:00,141.70999999999998,591.0,0,83,709,50,54,82,94,52.0,4,88.0,12
2008-02-25 12:00:00,107.71,447.6,0,79,175,48,52,87,100,50.0,4,93.5,13
2008-02-25 18:00:00,158.348,654.2,0,81,972,52,54,82,88,53.0,2,85.0,6
2008-02-26 00:00:00,96.72,403.2,0,78,0,48,54,82,100,51.0,6,91.0,18
2008-02-26 06:00:00,156.222,640.2,0,66,993,46,48,82,100,47.0,2,91.0,18
2008-02-26 12:00:00,95.396,397.0,0,63,0,48,50,82,100,49.0,2,91.0,18
2008-02-26 18:00:00,159.672,663.6,0,84,1020,50,52,94,94,51.0,2,94.0,0
2008-02-27 00:00:00,95.83,400.2,0,82,0,45,50,81,93,47.5,5,87.0,12
2008-02-27 06:00:00,158.308,654.0,0,90,1012,39,43,87,93,41.0,4,90.0,6
2008-02-27 12:00:00,133.668,558.0,0,77,623,37,46,81,93,41.5,9,87.0,12
2008-02-27 18:00:00,120.074,501.0,0,81,357,50,52,62,82,51.0,2,72.0,20
2008-02-28 00:00:00,154.67000000000002,640.1999999999999,0,78,977,43,50,66,87,46.5,7,76.5,21
2008-02-28 06:00:00,96.056,391.6,0,63,0,45,46,87,93,45.5,1,90.0,6
2008-02-28 12:00:00,156.524,651.6,0,58,1021,45,46,93,100,45.5,1,96.5,7
2008-02-28 18:00:00,99.428,412.6,0,79,0,48,55,88,100,51.5,7,94.0,12
2008-02-29 00:00:00,157.176,656.6,0,81,1007,54,54,88,100,54.0,0,94.0,12
2008-02-29 06:00:00,96.738,398.4,0,81,0,52,54,88,94,53.0,2,91.0,6
2008-02-29 12:00:00,456.45,1924.4,0,2310,2880,48,52,82,94,50.0,4,88.0,12
2008-02-29 18:00:00,580.934,2426.2,0,1268,5182,52,54,77,94,53.0,2,85.5,17
2008-03-01 00:00:00,199.226,827.6,0,114,0,52,54,82,88,53.0,2,85.0,6
2008-03-01 06:00:00,262.536,1073.2,0,107,968,52,55,82,88,53.5,3,85.0,6
2008-03-01 12:00:00,203.33,838.6,0,99,0,54,55,58,88,54.5,1,73.0,30
2008-03-01 18:00:00,265.886,1098.6,0,107,991,55,57,48,54,56.0,2,51.0,6
2008-03-02 00:00:00,410.124,1709.4,0,974,765,48,55,54,76,51.5,7,65.0,22
2008-03-02 06:00:00,112.718,470.0,0,96,163,48,50,71,82,49.0,2,76.5,11
2008-03-02 12:00:00,351.944,1484.2,0,2334,1273,48,52,87,93,50.0,4,90.0,6
2008-03-02 18:00:00,421.436,1821.0,0,2676,447,54,57,72,88,55.5,3,80.0,16
2008-03-03 00:00:00,276.12800000000004,1156.8,0,138,682,52,55,77,100,53.5,3,88.5,23
2008-03-03 06:00:00,255.774,1049.4,0,112,820,50,52,87,94,51.0,2,90.5,7
2008-03-03 12:00:00,205.318,840.2,0,96,0,43,50,76,93,46.5,7,84.5,17
2008-03-03 18:00:00,328.25,1345.0,0,1134,935,46,50,40,62,48.0,4,51.0,22
2008-03-04 00:00:00,251.208,1053.0,0,865,0,41,48,46,87,44.5,7,66.5,41
2008-03-04 06:00:00,265.554,1082.0,0,122,954,39,41,87,87,40.0,2,87.0,0
2008-03-04 12:00:00,230.798,1005.4,0,93,0,37,41,81,87,39.0,4,84.0,6
2008-03-04 18:00:00,760.438,3207.0,1249,2032,3554,39,45,57,87,42.0,6,72.0,30
2008-03-05 00:00:00,412.2,1715.0,0,196,4907,39,45,61,81,42.0,6,71.0,20
2008-03-05 06:00:00,101.716,422.8,0,90,0,34,39,70,81,36.5,5,75.5,11
2008-03-05 12:00:00,161.356,669.8,0,77,985,32,41,57,87,36.5,9,72.0,30
2008-03-05 18:00:00,627.452,2643.4,0,5380,3059,43,45,53,57,44.0,2,55.0,4
2008-03-06 00:00:00,1146.684,4862.0,1145,4250,1485,36,41,61,75,38.5,5,68.0,14
2008-03-06 06:00:00,522.944,2137.4,0,134,545,28,34,75,93,31.0,6,84.0,18
2008-03-06 12:00:00,838.542,3494.8,0,77,4245,34,37,81,87,35.5,3,84.0,6
2008-03-06 18:00:00,483.378,1974.6,0,81,0,41,48,71,87,44.5,7,79.0,16
2008-03-07 00:00:00,658.344,2782.2000000000003,1082,80,2175,45,46,81,87,45.5,1,84.0,6
2008-03-07 06:00:00,138.41,567.8,0,81,634,43,43,93,93,43.0,0,93.0,0
2008-03-07 12:00:00,673.7560000000001,2835.4,0,3009,4132,43,46,71,93,44.5,3,82.0,22
2008-03-07 18:00:00,386.25,1634.2,0,290,2820,46,50,62,71,48.0,4,66.5,9
2008-03-08 00:00:00,664.54,2798.6,1235,91,1447,45,48,76,93,46.5,3,84.5,17
2008-03-08 06:00:00,156.746,668.4,486,92,0,37,45,87,93,41.0,8,90.0,6
2008-03-08 12:00:00,255.012,1081.8,0,79,1413,34,48,71,93,41.0,14,82.0,22
2008-03-08 18:00:00,743.6600000000001,3119.2,2189,82,4535,50,52,54,66,51.0,2,60.0,12
2008-03-09 00:00:00,1093.242,4617.8,3611,93,2487,48,48,71,76,48.0,0,73.5,5
2008-03-09 06:00:00,350.068,1455.2,988,93,1200,46,48,71,87,47.0,2,79.0,16
2008-03-09 12:00:00,202.612,865.1999999999999,0,83,558,46,46,76,87,46.0,0,81.5,11
2008-03-09 18:00:00,369.866,1591.6,1081,90,1421,48,50,71,87,49.0,2,79.0,16
2008-03-10 00:00:00,637.912,2699.2,538,67,976,41,48,76,93,44.5,7,84.5,17
2008-03-10 06:00:00,158.006,663.4,0,82,594,39,41,87,93,40.0,2,90.0,6
2008-03-10 12:00:00,651.0219999999999,2717.4,1040,91,5643,41,45,76,87,43.0,4,81.5,11
2008-03-10 18:00:00,215.532,899.4,0,103,1576,43,50,71,93,46.5,7,82.0,22
2008-03-11 00:00:00,594.126,2505.8,969,92,847,48,48,71,76,48.0,0,73.5,5
2008-03-11 06:00:00,209.706,871.4,0,62,757,45,48,66,76,46.5,3,71.0,10
2008-03-11 12:00:00,411.68,1765.8000000000002,0,718,2146,43,46,76,81,44.5,3,78.5,5
2008-03-11 18:00:00,659.35,2819.0,240,2985,3782,46,57,82,100,51.5,11,91.0,18
2008-03-12 00:00:00,919.306,3856.2,1031,136,6251,55,57,82,88,56.0,2,85.0,6
2008-03-12 06:00:00,393.658,1606.2,0,101,4813,52,55,82,94,53.5,3,88.0,12
2008-03-12 12:00:00,516.826,2183.0,0,2036,3303,46,50,66,82,48.0,4,74.0,16
2008-03-12 18:00:00,156.872,664.2,0,100,645,48,54,44,66,51.0,6,55.0,22
2008-03-13 00:00:00,706.876,2994.6,1120,137,2281,43,50,47,70,46.5,7,58.5,23
2008-03-13 06:00:00,137.386,569.0,0,66,583,43,43,70,76,43.0,0,73.0,6
2008-03-13 12:00:00,400.258,1673.6,0,131,2180,43,50,71,87,46.5,7,79.0,16
2008-03-13 18:00:00,191.742,813.0,0,437,557,52,54,62,71,53.0,2,66.5,9
2008-03-14 00:00:00,946.128,4060.4,3263,2956,2144,48,52,71,93,50.0,4,82.0,22
2008-03-14 06:00:00,140.634,591.6,0,164,513,52,52,88,88,52.0,0,88.0,0
2008-03-14 12:00:00,634.706,2693.4,0,111,5049,52,55,77,88,53.5,3,82.5,11
2008-03-14 18:00:00,704.9259999999999,2923.2,980,792,6428,57,59,67,77,58.0,2,72.0,10
2008-03-15 00:00:00,729.954,3074.4,0,2814,2486,50,57,77,94,53.5,7,85.5,17
2008-03-15 06:00:00,155.144,659.2,0,187,738,45,50,93,100,47.5,5,96.5,7
2008-03-15 12:00:00,509.8,2162.0,1532,84,2731,45,57,67,100,51.0,12,83.5,33
2008-03-15 18:00:00,410.946,1770.0,0,155,1247,61,63,59,68,62.0,2,63.5,9
2008-03-16 00:00:00,500.41,2105.8,1018,76,1194,52,61,63,94,56.5,9,78.5,31
2008-03-16 06:00:00,190.016,803.4,0,150,293,48,50,87,93,49.0,2,90.0,6
2008-03-16 12:00:00,259.626,1108.4,0,169,1448,48,50,87,93,49.0,2,90.0,6
2008-03-16 18:00:00,409.634,1737.4,0,130,3748,52,57,67,94,54.5,5,80.5,27
2008-03-17 00:00:00,942.684,3980.4,2394,117,5797,46,50,82,93,48.0,4,87.5,11
2008-03-17 06:00:00,207.27,865.4,0,115,1690,45,48,87,100,46.5,3,93.5,13
2008-03-17 12:00:00,684.3919999999999,2876.0,0,2048,5519,43,45,66,93,44.0,2,79.5,27
2008-03-17 18:00:00,448.742,1934.2,0,4235,1237,45,48,57,71,46.5,3,64.0,14
2008-03-18 00:00:00,366.514,1534.4,236,253,900,41,45,61,76,43.0,4,68.5,15
2008-03-18 06:00:00,105.696,447.4,0,110,0,34,39,75,93,36.5,5,84.0,18
2008-03-18 12:00:00,592.418,2456.4,1156,105,5718,34,43,66,93,38.5,9,79.5,27
2008-03-18 18:00:00,638.496,2683.8,0,3574,4516,43,45,53,61,44.0,2,57.0,8
2008-03-19 00:00:00,580.956,2436.0,0,230,2310,41,45,57,70,43.0,4,63.5,13
2008-03-19 06:00:00,119.132,510.6,0,111,0,36,39,75,87,37.5,3,81.0,12
2008-03-19 12:00:00,529.672,2204.8,1391,99,4382,39,45,61,75,42.0,6,68.0,14
2008-03-19 18:00:00,201.696,861.0,655,102,636,43,48,54,70,45.5,5,62.0,16
2008-03-20 00:00:00,457.948,1932.4,64,99,1136,39,46,57,76,42.5,7,66.5,19
2008-03-20 06:00:00,143.768,611.8,0,96,655,32,37,81,93,34.5,5,87.0,12
2008-03-20 12:00:00,516.282,2157.0,1107,94,4468,30,46,66,100,38.0,16,83.0,34
2008-03-20 18:00:00,120.896,511.0,0,133,174,45,48,54,66,46.5,3,60.0,12
2008-03-21 00:00:00,472.328,1990.0,0,155,1373,45,46,62,76,45.5,1,69.0,14
2008-03-21 06:00:00,157.69,659.4,0,141,716,43,46,87,93,44.5,3,90.0,6
2008-03-21 12:00:00,506.144,2095.0,0,134,5663,45,48,81,93,46.5,3,87.0,12
2008-03-21 18:00:00,732.222,3093.8,1121,4076,4027,41,48,46,87,44.5,7,66.5,41
2008-03-22 00:00:00,670.386,2846.8,1050,427,2869,39,46,46,87,42.5,7,66.5,41
2008-03-22 06:00:00,154.322,668.6,0,395,496,36,39,87,93,37.5,3,90.0,6
2008-03-22 12:00:00,444.354,1869.6,1149,193,2961,36,39,87,93,37.5,3,90.0,6
2008-03-22 18:00:00,467.408,1975.8,1191,0,2664,41,48,66,87,44.5,7,76.5,21
2008-03-23 00:00:00,987.432,4155.2,982,0,6284,37,41,81,93,39.0,4,87.0,12
2008-03-23 06:00:00,119.178,529.2,0,0,143,32,37,75,81,34.5,5,78.0,6
2008-03-23 12:00:00,463.988,1952.6,984,57,4044,30,39,61,80,34.5,9,70.5,19
2008-03-23 18:00:00,830.0,3473.2,3908,74,6440,41,45,43,53,43.0,4,48.0,10
2008-03-24 00:00:00,912.824,3823.4,1387,1981,3251,34,43,53,93,38.5,9,73.0,40
2008-03-24 06:00:00,177.968,736.4,0,116,726,36,36,81,93,36.0,0,87.0,12
2008-03-24 12:00:00,458.456,1961.4,0,3496,1649,34,41,65,87,37.5,7,76.0,22
2008-03-24 18:00:00,612.4,2573.0,1131,2259,3413,41,43,65,76,42.0,2,70.5,11
2008-03-25 00:00:00,725.844,3014.8,0,117,1220,36,39,81,93,37.5,3,87.0,12
2008-03-25 06:00:00,103.83,449.2,0,67,25,32,36,87,93,34.0,4,90.0,6
2008-03-25 12:00:00,652.198,2713.8,1149,773,5969,34,41,65,93,37.5,7,79.0,28
2008-03-25 18:00:00,694.122,2903.4,0,2667,5936,41,46,53,76,43.5,5,64.5,23
2008-03-26 00:00:00,565.706,2387.2,1097,170,1564,39,45,57,81,42.0,6,69.0,24
2008-03-26 06:00:00,142.606,600.6,0,61,659,39,41,76,87,40.0,2,81.5,11
2008-03-26 12:00:00,608.748,2535.2,1255,65,5370,39,46,81,93,42.5,7,87.0,12
2008-03-26 18:00:00,285.324,1205.0,113,1646,823,48,50,71,82,49.0,2,76.5,11
2008-03-27 00:00:00,596.794,2518.0,1179,2059,695,46,48,76,87,47.0,2,81.5,11
2008-03-27 06:00:00,140.366,578.6,0,100,617,41,46,87,100,43.5,5,93.5,13
2008-03-27 12:00:00,503.712,2088.6,0,60,5032,41,46,76,93,43.5,5,84.5,17
2008-03-27 18:00:00,230.308,958.6,0,132,1865,48,52,54,66,50.0,4,60.0,12
2008-03-28 00:00:00,496.436,2077.8,0,64,1508,36,50,58,93,43.0,14,75.5,35
2008-03-28 06:00:00,140.636,571.4,0,94,621,32,36,93,93,34.0,4,93.0,0
2008-03-28 12:00:00,749.632,3141.6,1124,2544,5486,36,45,87,93,40.5,9,90.0,6
2008-03-28 18:00:00,348.784,1449.8,0,889,3140,48,50,76,94,49.0,2,85.0,18
2008-03-29 00:00:00,646.372,2727.0,1201,78,2334,45,50,76,87,47.5,5,81.5,11
2008-03-29 06:00:00,141.472,599.0,0,124,573,41,43,81,87,42.0,2,84.0,6
2008-03-29 12:00:00,561.3299999999999,2378.8,2348,50,3949,39,50,71,93,44.5,11,82.0,22
2008-03-29 18:00:00,653.438,2712.4,937,134,6466,52,57,48,67,54.5,5,57.5,19
2008-03-30 00:00:00,1114.91,4691.2,1868,67,6252,52,55,54,67,53.5,3,60.5,13
2008-03-30 06:00:00,540.204,2237.2,1219,112,3129,45,50,62,71,47.5,5,66.5,9
2008-03-30 12:00:00,290.244,1233.4,0,339,1738,46,52,54,67,49.0,6,60.5,13
2008-03-30 18:00:00,518.528,2190.0,1097,796,2510,50,50,82,94,50.0,0,88.0,12
2008-03-31 00:00:00,797.416,3379.0,2729,68,2392,46,50,82,93,48.0,4,87.5,11
2008-03-31 06:00:00,145.19400000000002,613.2,0,113,512,41,45,93,93,43.0,4,93.0,0
2008-03-31 12:00:00,540.4060000000001,2230.0,0,79,5350,41,46,87,100,43.5,5,93.5,13
2008-03-31 18:00:00,109.074,472.2,0,101,0,50,57,55,87,53.5,7,71.0,32
2008-04-01 00:00:00,582.896,2453.2,1091,118,3525,46,54,62,87,50.0,8,74.5,25
2008-04-01 06:00:00,205.562,845.8,0,54,1539,39,41,93,100,40.0,2,96.5,7
2008-04-01 12:00:00,463.418,1932.0,0,112,4531,41,45,93,100,43.0,4,96.5,7
2008-04-01 18:00:00,985.74,4140.2,0,6343,5881,54,57,72,82,55.5,3,77.0,10
2008-04-02 00:00:00,474.332,2013.6,1079,148,2564,41,57,72,93,49.0,16,82.5,21
2008-04-02 06:00:00,108.91,470.8,0,91,0,45,46,81,87,45.5,1,84.0,6
2008-04-02 12:00:00,563.83,2396.4,0,85,5304,46,55,67,87,50.5,9,77.0,20
2008-04-02 18:00:00,238.188,1026.8,0,543,1481,52,57,63,94,54.5,5,78.5,31
2008-04-03 00:00:00,780.744,3317.0,1106,2955,1204,48,52,82,94,50.0,4,88.0,12
2008-04-03 06:00:00,145.952,608.0,0,97,714,48,52,93,100,50.0,4,96.5,7
2008-04-03 12:00:00,522.516,2189.6,0,121,5140,48,55,67,100,51.5,7,83.5,33
2008-04-03 18:00:00,135.294,573.4,0,122,0,55,59,48,58,57.0,4,53.0,10
2008-04-04 00:00:00,324.994,1353.4,0,82,1047,46,55,58,94,50.5,9,76.0,36
2008-04-04 06:00:00,144.16400000000002,590.8,0,95,698,37,43,81,93,40.0,6,87.0,12
2008-04-04 12:00:00,619.3960000000001,2589.4,1123,499,5199,37,54,62,93,45.5,17,77.5,31
2008-04-04 18:00:00,278.418,1147.0,0,100,2819,55,61,42,59,58.0,6,50.5,17
2008-04-05 00:00:00,589.94,2478.8,1010,81,4530,43,57,63,82,50.0,14,72.5,19
2008-04-05 06:00:00,148.99,616.2,0,125,753,43,48,87,93,45.5,5,90.0,6
2008-04-05 12:00:00,337.012,1428.2,524,119,1743,45,50,76,100,47.5,5,88.0,24
2008-04-05 18:00:00,745.524,3146.6,1201,63,6422,48,54,67,87,51.0,6,77.0,20
2008-04-06 00:00:00,739.236,3139.2,1204,567,4726,43,50,57,87,46.5,7,72.0,30
2008-04-06 06:00:00,156.148,652.4,0,119,753,37,41,81,93,39.0,4,87.0,12
2008-04-06 12:00:00,453.594,1918.2,522,1498,1366,39,41,76,93,40.0,2,84.5,17
2008-04-06 18:00:00,429.034,1788.4,602,864,3193,43,46,57,76,44.5,3,66.5,19
2008-04-07 00:00:00,657.542,2763.8,0,134,2240,34,41,76,93,37.5,7,84.5,17
2008-04-07 06:00:00,157.478,645.0,0,55,780,32,32,93,100,32.0,0,96.5,7
2008-04-07 12:00:00,537.654,2242.0,1153,109,4900,32,43,70,93,37.5,11,81.5,23
2008-04-07 18:00:00,210.534,911.2,0,56,1143,43,48,50,70,45.5,5,60.0,20
2008-04-08 00:00:00,633.172,2659.0,1267,452,2643,32,45,53,87,38.5,13,70.0,34
2008-04-08 06:00:00,153.946,636.2,0,56,871,30,34,87,100,32.0,4,93.5,13
2008-04-08 12:00:00,1137.444,4751.6,1130,6466,5991,34,45,53,81,39.5,11,67.0,28
2008-04-08 18:00:00,793.708,3301.8,619,4101,6676,46,48,50,54,47.0,2,52.0,4
2008-04-09 00:00:00,572.418,2397.6,1003,90,3981,32,46,53,93,39.0,14,73.0,40
2008-04-09 06:00:00,145.762,607.6,0,112,705,43,45,61,70,44.0,2,65.5,9
2008-04-09 12:00:00,540.3199999999999,2228.6,0,57,5724,41,46,70,76,43.5,5,73.0,6
2008-04-09 18:00:00,154.418,652.0,0,119,681,45,46,66,76,45.5,1,71.0,10
2008-04-10 00:00:00,378.352,1584.8,0,88,1893,43,46,66,81,44.5,3,73.5,15
2008-04-10 06:00:00,115.488,485.0,0,90,244,37,41,81,81,39.0,4,81.0,0
2008-04-10 12:00:00,566.992,2354.8,1196,131,4433,39,50,47,81,44.5,11,64.0,34
2008-04-10 18:00:00,122.968,519.8,0,141,244,52,55,36,44,53.5,3,40.0,8
2008-04-11 00:00:00,672.298,2840.2,2065,95,1606,43,52,47,81,47.5,9,64.0,34
2008-04-11 06:00:00,210.756,875.5999999999999,733,84,1084,45,46,57,66,45.5,1,61.5,9
2008-04-11 12:00:00,587.406,2444.8,0,85,5816,41,52,54,76,46.5,11,65.0,22
2008-04-11 18:00:00,377.168,1564.4,0,239,4181,52,57,36,54,54.5,5,45.0,18
2008-04-12 00:00:00,702.334,2967.0,1069,83,3441,46,55,54,71,50.5,9,62.5,17
2008-04-12 06:00:00,206.452,854.0,0,82,858,39,45,81,93,42.0,6,87.0,12
2008-04-12 12:00:00,400.21,1700.8,1081,165,2632,39,52,76,93,45.5,13,84.5,17
2008-04-12 18:00:00,855.284,3655.0,3288,833,5100,54,57,51,67,55.5,3,59.0,16
2008-04-13 00:00:00,1338.068,5624.400000000001,2707,1419,6635,45,55,54,93,50.0,10,73.5,39
2008-04-13 06:00:00,569.408,2346.0,544,444,5731,46,46,87,93,46.0,0,90.0,6
2008-04-13 12:00:00,351.72200000000004,1480.2,0,611,1983,45,50,76,93,47.5,5,84.5,17
2008-04-13 18:00:00,421.606,1783.0,493,1828,2459,52,54,67,76,53.0,2,71.5,9
2008-04-14 00:00:00,890.25,3825.4,1517,3059,2834,46,48,87,93,47.0,2,90.0,6
2008-04-14 06:00:00,154.71800000000002,657.2,0,74,767,45,45,93,93,45.0,0,93.0,0
2008-04-14 12:00:00,603.3,2504.4,0,139,5737,43,50,71,93,46.5,7,82.0,22
2008-04-14 18:00:00,297.29,1231.6,0,135,2675,45,52,67,87,48.5,7,77.0,20
2008-04-15 00:00:00,534.274,2237.0,0,77,2018,43,50,57,100,46.5,7,78.5,43
2008-04-15 06:00:00,129.016,538.2,0,131,352,37,41,81,93,39.0,4,87.0,12
2008-04-15 12:00:00,588.726,2468.4,676,819,5309,41,48,62,87,44.5,7,74.5,25
2008-04-15 18:00:00,476.972,2041.8,498,2887,2127,48,54,41,62,51.0,6,51.5,21
2008-04-16 00:00:00,475.692,2021.4,0,161,2086,37,52,43,87,44.5,15,65.0,44
2008-04-16 06:00:00,128.442,530.1999999999999,0,70,346,32,36,81,93,34.0,4,87.0,12
2008-04-16 12:00:00,467.066,1949.8,0,129,4853,30,52,50,93,41.0,22,71.5,43
2008-04-16 18:00:00,337.656,1431.0,0,85,3017,54,55,33,47,54.5,1,40.0,14
2008-04-17 00:00:00,555.9,2304.2000000000003,838,119,3106,37,54,38,75,45.5,17,56.5,37
2008-04-17 06:00:00,161.058,678.6,0,134,911,37,43,53,70,40.0,6,61.5,17
2008-04-17 12:00:00,447.722,1869.4,0,67,4590,37,50,43,75,43.5,13,59.0,32
2008-04-17 18:00:00,127.254,575.8,0,146,243,50,54,44,47,52.0,4,45.5,3
2008-04-18 00:00:00,659.828,2786.4,1719,70,2894,41,52,47,66,46.5,11,56.5,19
2008-04-18 06:00:00,164.084,691.6,0,145,835,45,45,81,100,45.0,0,90.5,19
2008-04-18 12:00:00,718.3599999999999,3039.6,1228,1733,4843,45,54,72,100,49.5,9,86.0,28
2008-04-18 18:00:00,481.892,2026.4,133,1784,3709,55,59,59,72,57.0,4,65.5,13
2008-04-19 00:00:00,498.054,2101.4,813,170,1534,45,59,59,94,52.0,14,76.5,35
2008-04-19 06:00:00,181.092,783.5999999999999,0,94,843,50,50,94,94,50.0,0,94.0,0
2008-04-19 12:00:00,425.666,1812.4,0,151,3539,50,54,82,94,52.0,4,88.0,12
2008-04-19 18:00:00,756.334,3194.2,2535,2006,4243,55,61,52,72,58.0,6,62.0,20
2008-04-20 00:00:00,890.6179999999999,3765.8,1784,206,6097,50,59,51,100,54.5,9,75.5,49
2008-04-20 06:00:00,199.56,841.0,0,85,295,48,50,76,82,49.0,2,79.0,6
2008-04-20 12:00:00,259.13800000000003,1108.2,0,150,1692,46,54,72,87,50.0,8,79.5,15
2008-04-20 18:00:00,508.716,2105.0,0,140,5732,55,61,67,77,58.0,6,72.0,10
2008-04-21 00:00:00,824.004,3521.0,1030,4169,2682,46,59,67,94,52.5,13,80.5,27
2008-04-21 06:00:00,163.072,693.2,0,190,827,52,54,82,100,53.0,2,91.0,18
2008-04-21 12:00:00,447.162,1863.6,0,137,4586,52,55,77,82,53.5,3,79.5,5
2008-04-21 18:00:00,128.91,555.8,0,170,292,55,59,63,72,57.0,4,67.5,9
2008-04-22 00:00:00,425.012,1789.4,0,2176,1083,52,57,67,94,54.5,5,80.5,27
2008-04-22 06:00:00,176.536,754.6,0,258,1041,45,46,93,100,45.5,1,96.5,7
2008-04-22 12:00:00,356.65000000000003,1505.4,971,162,2368,48,59,72,100,53.5,11,86.0,28
2008-04-22 18:00:00,764.948,3224.0,0,4480,5055,61,66,56,68,63.5,5,62.0,12
2008-04-23 00:00:00,329.542,1388.4,0,193,2139,48,64,59,93,56.0,16,76.0,34
2008-04-23 06:00:00,178.172,745.0,0,94,1211,45,54,87,100,49.5,9,93.5,13
2008-04-23 12:00:00,408.44,1711.0,0,158,4354,48,57,77,100,52.5,9,88.5,23
2008-04-23 18:00:00,155.368,673.4000000000001,0,152,291,55,61,68,88,58.0,6,78.0,20
2008-04-24 00:00:00,615.348,2583.8,1380,88,2550,48,63,48,82,55.5,15,65.0,34
2008-04-24 06:00:00,297.918,1251.2,1263,147,1578,39,43,87,93,41.0,4,90.0,6
2008-04-24 12:00:00,253.626,1074.6,0,143,1892,39,63,48,100,51.0,24,74.0,52
2008-04-24 18:00:00,156.974,664.6,0,103,862,63,64,39,52,63.5,1,45.5,13
2008-04-25 00:00:00,335.254,1413.2,0,129,964,45,55,77,88,50.0,10,82.5,11
2008-04-25 06:00:00,119.866,512.4,0,145,239,45,50,87,94,47.5,5,90.5,7
2008-04-25 12:00:00,426.148,1774.4,0,127,4645,45,57,63,93,51.0,12,78.0,30
2008-04-25 18:00:00,526.5500000000001,2211.2000000000003,824,1574,4179,59,64,37,51,61.5,5,44.0,14
2008-04-26 00:00:00,195.17,830.0,0,158,337,52,66,37,88,59.0,14,62.5,51
2008-04-26 06:00:00,161.634,685.0,0,149,922,43,52,67,93,47.5,9,80.0,26
2008-04-26 12:00:00,216.888,913.8,0,124,1081,45,64,52,93,54.5,19,72.5,41
2008-04-26 18:00:00,220.51,921.6,0,111,339,64,70,37,46,67.0,6,41.5,9
2008-04-27 00:00:00,304.134,1272.6,0,250,1244,52,68,49,67,60.0,16,58.0,18
2008-04-27 06:00:00,228.178,962.4,0,149,390,50,57,67,82,53.5,7,74.5,15
2008-04-27 12:00:00,231.218,967.8,0,162,1249,48,70,46,87,59.0,22,66.5,41
2008-04-27 18:00:00,279.652,1201.4,693,141,1261,72,77,36,50,74.5,5,43.0,14
2008-04-28 00:00:00,269.192,1136.2,0,136,2588,59,70,49,64,64.5,11,56.5,15
2008-04-28 06:00:00,183.328,777.6,0,184,1004,55,61,77,88,58.0,6,82.5,11
2008-04-28 12:00:00,158.17600000000002,672.4,0,143,342,52,54,67,94,53.0,2,80.5,27
2008-04-28 18:00:00,188.534,803.0,0,124,1097,52,61,52,88,56.5,9,70.0,36
2008-04-29 00:00:00,129.014,556.0,0,170,343,48,63,67,93,55.5,15,80.0,26
2008-04-29 06:00:00,178.64,753.8,0,150,1181,43,45,93,100,44.0,2,96.5,7
2008-04-29 12:00:00,372.474,1595.0,1173,1065,1642,45,52,82,93,48.5,7,87.5,11
2008-04-29 18:00:00,710.6080000000001,2989.4,229,4068,4275,50,54,82,94,52.0,4,88.0,12
2008-04-30 00:00:00,710.894,2971.6,0,128,3383,45,54,82,93,49.5,9,87.5,11
2008-04-30 06:00:00,518.718,2169.2,1057,175,2479,46,52,76,93,49.0,6,84.5,17
2008-04-30 12:00:00,301.978,1270.2,0,158,3046,46,52,76,87,49.0,6,81.5,11
2008-04-30 18:00:00,122.018,517.0,0,95,288,52,57,58,82,54.5,5,70.0,24
2008-05-01 00:00:00,159.012,678.4,0,162,840,48,55,63,87,51.5,7,75.0,24
2008-05-01 06:00:00,162.726,690.4,0,144,962,43,46,87,93,44.5,3,90.0,6
2008-05-01 12:00:00,117.048,495.8,0,80,240,43,54,71,93,48.5,11,82.0,22
2008-05-01 18:00:00,173.328,733.6,0,153,1100,54,59,55,77,56.5,5,66.0,22
2008-05-02 00:00:00,122.912,531.6,0,153,284,46,55,67,87,50.5,9,77.0,20
2008-05-02 06:00:00,173.082,723.0,0,84,1176,45,46,93,100,45.5,1,96.5,7
2008-05-02 12:00:00,405.974,1729.6,796,200,2839,45,59,67,100,52.0,14,83.5,33
2008-05-02 18:00:00,218.758,921.8,0,154,1799,61,66,45,59,63.5,5,52.0,14
2008-05-03 00:00:00,699.954,2929.6,2318,146,2873,48,63,48,87,55.5,15,67.5,39
2008-05-03 06:00:00,430.644,1816.8,0,85,1114,50,52,76,87,51.0,2,81.5,11
2008-05-03 12:00:00,390.794,1667.1999999999998,996,155,2795,54,68,52,77,61.0,14,64.5,25
2008-05-03 18:00:00,153.99,664.4,0,168,706,70,73,41,50,71.5,3,45.5,9
2008-05-04 00:00:00,314.172,1325.0,0,133,1920,54,72,46,77,63.0,18,61.5,31
2008-05-04 06:00:00,205.902,865.8,0,120,969,54,59,72,82,56.5,5,77.0,10
2008-05-04 12:00:00,204.154,869.2,0,160,921,54,70,52,77,62.0,16,64.5,25
2008-05-04 18:00:00,315.522,1365.4,0,806,1034,72,75,41,50,73.5,3,45.5,9
2008-05-05 00:00:00,745.392,3181.6,2196,1786,2540,61,72,43,68,66.5,11,55.5,25
2008-05-05 06:00:00,164.386,687.8,0,81,896,55,57,63,72,56.0,2,67.5,9
2008-05-05 12:00:00,604.836,2530.4,1008,106,6423,55,68,49,63,61.5,13,56.0,14
2008-05-05 18:00:00,195.558,830.6,0,82,1229,70,72,31,40,71.0,2,35.5,9
2008-05-06 00:00:00,402.152,1708.0,0,109,1649,59,70,35,59,64.5,11,47.0,24
2008-05-06 06:00:00,180.258,768.6,0,82,1102,54,61,52,72,57.5,7,62.0,20
2008-05-06 12:00:00,383.014,1605.6,0,108,4039,54,66,56,72,60.0,12,64.0,16
2008-05-06 18:00:00,769.726,3262.8,1354,4895,3938,68,73,38,46,70.5,5,42.0,8
2008-05-07 00:00:00,456.982,1917.2,0,325,3121,59,72,43,56,65.5,13,49.5,13
2008-05-07 06:00:00,133.966,576.4,0,110,403,50,61,68,94,55.5,11,81.0,26
2008-05-07 12:00:00,414.222,1746.2,0,107,4182,52,70,60,88,61.0,18,74.0,28
2008-05-07 18:00:00,207.888,893.1999999999999,1030,90,400,73,77,36,53,75.0,4,44.5,17
2008-05-08 00:00:00,420.188,1763.0,0,116,1664,64,73,38,59,68.5,9,48.5,21
2008-05-08 06:00:00,413.46,1715.1999999999998,0,83,725,55,63,52,67,59.0,8,59.5,15
2008-05-08 12:00:00,342.618,1443.8000000000002,0,419,1944,55,73,41,72,64.0,18,56.5,31
2008-05-08 18:00:00,580.364,2436.8,1519,114,5448,75,79,36,39,77.0,4,37.5,3
2008-05-09 00:00:00,780.256,3301.2,2148,86,4600,64,77,44,68,70.5,13,56.0,24
2008-05-09 06:00:00,171.56799999999998,741.6,0,113,480,55,64,49,88,59.5,9,68.5,39
2008-05-09 12:00:00,554.112,2344.0,0,111,4229,57,72,53,77,64.5,15,65.0,24
2008-05-09 18:00:00,567.356,2392.2,1120,89,4166,70,75,33,49,72.5,5,41.0,16
2008-05-10 00:00:00,454.236,1918.2,1109,110,3029,63,70,49,68,66.5,7,58.5,19
2008-05-10 06:00:00,150.858,635.0,0,111,511,57,61,67,77,59.0,4,72.0,10
2008-05-10 12:00:00,433.89,1873.2,2632,122,1692,61,72,53,68,66.5,11,60.5,15
2008-05-10 18:00:00,714.54,3062.0,3661,244,5002,73,79,28,47,76.0,6,37.5,19
2008-05-11 00:00:00,609.84,2546.2,657,135,4509,61,77,39,68,69.0,16,53.5,29
2008-05-11 06:00:00,445.48,1904.8,563,538,1011,57,66,49,63,61.5,9,56.0,14
2008-05-11 12:00:00,260.544,1132.4,0,446,2136,59,75,38,59,67.0,16,48.5,21
2008-05-11 18:00:00,456.672,1967.2,0,195,2749,75,77,32,38,76.0,2,35.0,6
2008-05-12 00:00:00,448.2240000000001,1913.6,0,161,1034,59,75,33,63,67.0,16,48.0,30
2008-05-12 06:00:00,107.212,484.6,0,129,479,54,61,59,77,57.5,7,68.0,18
2008-05-12 12:00:00,413.676,1776.1999999999998,1007,417,3025,55,72,46,72,63.5,17,59.0,26
2008-05-12 18:00:00,549.97,2295.4,0,408,6464,73,77,36,44,75.0,4,40.0,8
2008-05-13 00:00:00,453.346,1951.8,1075,131,1991,63,75,38,56,69.0,12,47.0,18
2008-05-13 06:00:00,109.81,495.8,0,174,469,54,63,55,72,58.5,9,63.5,17
2008-05-13 12:00:00,340.148,1435.8,0,112,3577,54,75,36,77,64.5,21,56.5,41
2008-05-13 18:00:00,627.934,2694.2,823,3544,3463,77,79,28,36,78.0,2,32.0,8
2008-05-14 00:00:00,399.002,1698.4,0,259,861,64,77,34,59,70.5,13,46.5,25
2008-05-14 06:00:00,154.752,674.8,0,136,1022,57,61,72,82,59.0,4,77.0,10
2008-05-14 12:00:00,590.5219999999999,2501.2,1204,188,6024,57,75,44,88,66.0,18,66.0,44
2008-05-14 18:00:00,405.86,1773.0,1263,2638,1105,68,79,41,64,73.5,11,52.5,23
2008-05-15 00:00:00,433.128,1838.2,0,474,1565,59,66,68,94,62.5,7,81.0,26
2008-05-15 06:00:00,117.104,529.4,0,126,644,57,59,94,100,58.0,2,97.0,6
2008-05-15 12:00:00,426.41,1810.2,868,153,3885,57,57,100,100,57.0,0,100.0,0
2008-05-15 18:00:00,197.562,911.4,0,161,468,57,57,100,100,57.0,0,100.0,0
2008-05-16 00:00:00,421.692,1820.8,0,130,1823,57,66,63,100,61.5,9,81.5,37
2008-05-16 06:00:00,149.432,666.0,0,133,1000,55,59,88,94,57.0,4,91.0,6
2008-05-16 12:00:00,300.188,1291.2,0,174,2865,54,68,60,94,61.0,14,77.0,34
2008-05-16 18:00:00,583.75,2497.4,977,2112,3317,68,72,56,60,70.0,4,58.0,4
2008-05-17 00:00:00,614.66,2623.6,1251,146,1773,59,68,64,88,63.5,9,76.0,24
2008-05-17 06:00:00,136.478,607.0,0,182,927,55,59,88,100,57.0,4,94.0,12
2008-05-17 12:00:00,468.994,2014.2,890,191,4101,55,63,72,94,59.0,8,83.0,22
2008-05-17 18:00:00,264.034,1182.2,0,413,1665,64,66,56,73,65.0,2,64.5,17
2008-05-18 00:00:00,787.948,3326.8,1268,149,5779,52,61,72,94,56.5,9,83.0,22
2008-05-18 06:00:00,291.704,1294.4,806,265,1166,48,54,94,100,51.0,6,97.0,6
2008-05-18 12:00:00,319.698,1377.2,0,159,2319,50,63,72,94,56.5,13,83.0,22
2008-05-18 18:00:00,292.906,1292.2,0,319,2383,54,61,72,94,57.5,7,83.0,22
2008-05-19 00:00:00,899.65,3825.8,969,4612,2758,52,57,72,94,54.5,5,83.0,22
2008-05-19 06:00:00,104.616,478.8,0,227,411,48,52,76,82,50.0,4,79.0,6
2008-05-19 12:00:00,469.194,1965.8,0,88,5254,48,59,59,82,53.5,11,70.5,23
2008-05-19 18:00:00,89.962,413.2,0,132,288,61,61,55,59,61.0,0,57.0,4
2008-05-20 00:00:00,366.49,1562.2,1014,111,1550,52,59,55,82,55.5,7,68.5,27
2008-05-20 06:00:00,138.828,591.2,0,111,968,48,52,62,71,50.0,4,66.5,9
2008-05-20 12:00:00,487.848,2070.4,858,504,4433,48,61,48,71,54.5,13,59.5,23
2008-05-20 18:00:00,582.394,2459.8,494,1704,5240,63,66,40,49,64.5,3,44.5,9
2008-05-21 00:00:00,372.264,1621.0,0,112,1336,54,66,46,59,60.0,12,52.5,13
2008-05-21 06:00:00,130.564,567.6,0,127,1006,46,55,67,81,50.5,9,74.0,14
2008-05-21 12:00:00,484.326,2016.6,0,91,5826,48,64,42,82,56.0,16,62.0,40
2008-05-21 18:00:00,167.626,749.8000000000001,1038,124,343,64,68,37,42,66.0,4,39.5,5
2008-05-22 00:00:00,541.596,2306.0,951,132,2076,57,64,45,63,60.5,7,54.0,18
2008-05-22 06:00:00,102.19,465.6,0,87,347,57,59,59,67,58.0,2,63.0,8
2008-05-22 12:00:00,352.052,1499.0,0,131,3788,57,66,52,72,61.5,9,62.0,20
2008-05-22 18:00:00,120.068,567.6,0,121,348,66,66,43,49,66.0,0,46.0,6
2008-05-23 00:00:00,402.558,1724.4,996,101,1992,57,66,45,67,61.5,9,56.0,22
2008-05-23 06:00:00,94.486,427.0,0,132,346,52,55,72,82,53.5,3,77.0,10
2008-05-23 12:00:00,649.9200000000001,2737.2,0,992,6396,52,68,43,82,60.0,16,62.5,39
2008-05-23 18:00:00,490.772,2034.0,0,129,6677,68,72,43,46,70.0,4,44.5,3
2008-05-24 00:00:00,249.738,1078.2,0,137,1315,55,70,46,72,62.5,15,59.0,26
2008-05-24 06:00:00,148.438,636.4,0,92,1301,61,63,68,72,62.0,2,70.0,4
2008-05-24 12:00:00,337.112,1441.6,0,170,3734,61,72,53,68,66.5,11,60.5,15
2008-05-24 18:00:00,451.192,1911.2,0,152,5267,64,72,53,88,68.0,8,70.5,35
2008-05-25 00:00:00,643.434,2734.2,1027,155,2531,63,64,59,94,63.5,1,76.5,35
2008-05-25 06:00:00,245.12,1044.0,0,164,928,55,61,94,94,58.0,6,94.0,0
2008-05-25 12:00:00,274.414,1208.8,526,479,748,57,66,68,88,61.5,9,78.0,20
2008-05-25 18:00:00,641.152,2768.6,1104,4942,2020,68,72,46,60,70.0,4,53.0,14
2008-05-26 00:00:00,887.818,3815.2,2677,3226,2320,61,68,64,94,64.5,7,79.0,30
2008-05-26 06:00:00,113.242,539.6,0,236,417,59,61,88,100,60.0,2,94.0,12
2008-05-26 12:00:00,541.278,2287.2,0,140,6096,59,63,77,94,61.0,4,85.5,17
2008-05-26 18:00:00,197.398,929.2,0,130,703,61,66,68,94,63.5,5,81.0,26
2008-05-27 00:00:00,437.792,1902.8,985,160,2068,57,61,88,100,59.0,4,94.0,12
2008-05-27 06:00:00,107.546,526.0,0,103,406,54,55,94,100,54.5,1,97.0,6
2008-05-27 12:00:00,521.12,2224.8,0,171,5281,55,61,94,100,58.0,6,97.0,6
2008-05-27 18:00:00,615.156,2626.8,0,3977,3175,61,64,94,100,62.5,3,97.0,6
2008-05-28 00:00:00,464.878,1977.0,0,1101,2616,57,64,88,94,60.5,7,91.0,6
2008-05-28 06:00:00,97.438,432.2,0,134,406,59,59,94,100,59.0,0,97.0,6
2008-05-28 12:00:00,372.76,1579.0,0,106,3839,57,64,73,94,60.5,7,83.5,21
2008-05-28 18:00:00,175.68200000000002,787.8000000000001,1020,158,345,66,72,56,64,69.0,6,60.0,8
2008-05-29 00:00:00,468.492,2025.8,2118,114,2119,61,70,56,94,65.5,9,75.0,38
2008-05-29 06:00:00,115.986,551.0,0,151,404,55,59,88,100,57.0,4,94.0,12
2008-05-29 12:00:00,537.244,2306.2,0,103,6272,59,66,73,94,62.5,7,83.5,21
2008-05-29 18:00:00,141.624,647.2,0,151,803,64,68,64,88,66.0,4,76.0,24
2008-05-30 00:00:00,340.222,1500.6,1004,102,1224,59,70,68,88,64.5,11,78.0,20
2008-05-30 06:00:00,101.948,460.6,0,156,346,57,61,94,100,59.0,4,97.0,6
2008-05-30 12:00:00,660.054,2813.4,0,2282,5834,59,70,73,100,64.5,11,86.5,27
2008-05-30 18:00:00,340.00800000000004,1484.0,0,454,3031,70,72,57,68,71.0,2,62.5,11
2008-05-31 00:00:00,295.23400000000004,1294.2,0,127,2087,59,72,60,94,65.5,13,77.0,34
2008-05-31 06:00:00,119.714,525.4,0,149,764,57,59,88,94,58.0,2,91.0,6
2008-05-31 12:00:00,344.17,1502.0,0,126,3344,57,66,68,94,61.5,9,81.0,26
2008-05-31 18:00:00,546.708,2361.4,1060,1813,3305,64,68,64,73,66.0,4,68.5,9
2008-06-01 00:00:00,630.8779999999999,2700.4,704,240,4445,57,64,73,88,60.5,7,80.5,15
2008-06-01 06:00:00,281.362,1214.4,0,153,971,55,57,88,100,56.0,2,94.0,12
2008-06-01 12:00:00,324.872,1394.2,937,117,2418,55,68,64,100,61.5,13,82.0,36
2008-06-01 18:00:00,439.796,1847.8,969,149,2625,68,72,57,68,70.0,4,62.5,11
2008-06-02 00:00:00,802.846,3353.0,0,126,5293,57,70,68,94,63.5,13,81.0,26
2008-06-02 06:00:00,99.43,440.0,0,136,408,61,63,82,94,62.0,2,88.0,12
2008-06-02 12:00:00,518.472,2209.2,960,139,3710,61,70,68,94,65.5,9,81.0,26
2008-06-02 18:00:00,192.208,840.6,0,132,450,66,70,73,88,68.0,4,80.5,15
2008-06-03 00:00:00,263.902,1144.2,0,151,1773,63,70,73,94,66.5,7,83.5,21
2008-06-03 06:00:00,146.168,652.4,0,108,1049,59,63,88,94,61.0,4,91.0,6
2008-06-03 12:00:00,541.322,2333.2,955,156,5599,59,63,77,94,61.0,4,85.5,17
2008-06-03 18:00:00,172.44400000000002,776.4,0,106,498,59,64,73,82,61.5,5,77.5,9
2008-06-04 00:00:00,737.8820000000001,3213.6,1942,2238,2119,55,63,82,94,59.0,8,88.0,12
2008-06-04 06:00:00,170.556,757.4000000000001,497,205,1019,54,63,94,94,58.5,9,94.0,0
2008-06-04 12:00:00,652.0699999999999,2834.4,0,4202,4077,54,61,77,94,57.5,7,85.5,17
2008-06-04 18:00:00,294.296,1300.0,0,3074,388,63,66,56,72,64.5,3,64.0,16
2008-06-05 00:00:00,471.99,2060.2,1053,201,1024,54,64,59,94,59.0,10,76.5,35
2008-06-05 06:00:00,142.768,632.2,0,132,991,57,59,67,82,58.0,2,74.5,15
2008-06-05 12:00:00,431.864,1852.6,0,112,5033,57,64,45,67,60.5,7,56.0,22
2008-06-05 18:00:00,200.96,896.4,0,154,1473,66,68,43,56,67.0,2,49.5,13
2008-06-06 00:00:00,344.486,1511.4,1747,108,1284,61,64,55,72,62.5,3,63.5,17
2008-06-06 06:00:00,154.97,699.4000000000001,0,146,1092,59,61,55,67,60.0,2,61.0,12
2008-06-06 12:00:00,326.022,1398.2,0,109,3325,55,59,67,82,57.0,4,74.5,15
2008-06-06 18:00:00,187.27,867.0,0,149,331,61,64,55,63,62.5,3,59.0,8
2008-06-07 00:00:00,549.452,2323.2,1009,102,3123,57,61,59,72,59.0,4,65.5,13
2008-06-07 06:00:00,209.756,875.4000000000001,0,141,377,50,55,77,94,52.5,5,85.5,17
2008-06-07 12:00:00,584.4,2444.4,0,370,5564,54,63,72,88,58.5,9,80.0,16
2008-06-07 18:00:00,749.6320000000001,3173.6,1027,1979,6656,63,66,59,68,64.5,3,63.5,9
2008-06-08 00:00:00,338.696,1472.6,1352,121,1996,55,64,55,77,59.5,9,66.0,22
2008-06-08 06:00:00,146.574,631.6,0,112,1020,50,59,55,87,54.5,9,71.0,32
2008-06-08 12:00:00,171.054,747.4000000000001,0,139,1373,50,63,72,94,56.5,13,83.0,22
2008-06-08 18:00:00,587.3679999999999,2484.2,1354,96,5134,63,70,60,72,66.5,7,66.0,12
2008-06-09 00:00:00,637.326,2755.2,1182,2814,2205,61,70,52,83,65.5,9,67.5,31
2008-06-09 06:00:00,104.2,471.8,0,217,441,61,63,88,94,62.0,2,91.0,6
2008-06-09 12:00:00,521.504,2253.8,1018,1566,3685,59,75,57,94,67.0,16,75.5,37
2008-06-09 18:00:00,248.45,1129.2,0,197,1693,77,81,34,54,79.0,4,44.0,20
2008-06-10 00:00:00,451.544,1962.4,949,105,2102,64,79,44,83,71.5,15,63.5,39
2008-06-10 06:00:00,108.502,494.4,1,158,497,61,66,78,88,63.5,5,83.0,10
2008-06-10 12:00:00,520.7860000000001,2187.0,0,132,6509,63,77,50,77,70.0,14,63.5,27
2008-06-10 18:00:00,115.332,522.0,0,130,575,79,81,39,45,80.0,2,42.0,6
2008-06-11 00:00:00,322.47,1411.6,906,165,1411,70,79,36,73,74.5,9,54.5,37
2008-06-11 06:00:00,149.53,654.8,0,115,1273,57,66,72,78,61.5,9,75.0,6
2008-06-11 12:00:00,407.126,1747.4,972,411,3419,59,68,56,72,63.5,9,64.0,16
2008-06-11 18:00:00,184.836,841.0,5,204,1134,68,73,50,56,70.5,5,53.0,6
2008-06-12 00:00:00,381.714,1636.2,0,112,1740,59,68,56,73,63.5,9,64.5,17
2008-06-12 06:00:00,114.49,528.0,0,151,451,50,55,77,94,52.5,5,85.5,17
2008-06-12 12:00:00,583.102,2480.8,1032,165,4480,55,63,77,88,59.0,8,82.5,11
2008-06-12 18:00:00,164.606,766.6,0,103,438,57,63,59,88,60.0,6,73.5,29
2008-06-13 00:00:00,397.134,1695.6,919,148,1877,54,61,55,72,57.5,7,63.5,17
2008-06-13 06:00:00,130.814,572.8,0,131,989,45,52,76,100,48.5,7,88.0,24
2008-06-13 12:00:00,469.15,1974.2,0,477,5418,48,61,52,94,54.5,13,73.0,42
2008-06-13 18:00:00,641.986,2792.6000000000004,0,5772,2695,59,63,45,51,61.0,4,48.0,6
2008-06-14 00:00:00,632.33,2727.4,2809,978,1429,52,63,45,76,57.5,11,60.5,31
2008-06-14 06:00:00,117.736,575.8,0,140,416,52,55,77,88,53.5,3,82.5,11
2008-06-14 12:00:00,298.176,1316.0,0,196,2588,50,63,55,94,56.5,13,74.5,39
2008-06-14 18:00:00,477.23,2011.6,0,419,5622,64,68,40,52,66.0,4,46.0,12
2008-06-15 00:00:00,491.778,2155.8,1862,256,2055,54,66,45,77,60.0,12,61.0,32
2008-06-15 06:00:00,207.412,875.4,0,241,954,48,54,72,93,51.0,6,82.5,21
2008-06-15 12:00:00,391.678,1671.6,0,379,3378,50,59,63,87,54.5,9,75.0,24
2008-06-15 18:00:00,898.786,3832.2,6088,691,5492,57,64,55,82,60.5,7,68.5,27
2008-06-16 00:00:00,791.226,3374.8,383,5491,1765,55,57,59,88,56.0,2,73.5,29
2008-06-16 06:00:00,116.414,545.6,0,157,387,54,54,88,94,54.0,0,91.0,6
2008-06-16 12:00:00,514.872,2164.0,988,98,5285,54,64,59,94,59.0,10,76.5,35
2008-06-16 18:00:00,164.088,746.4,0,100,1034,63,66,56,68,64.5,3,62.0,12
2008-06-17 00:00:00,507.67,2166.8,992,109,3306,54,66,49,88,60.0,12,68.5,39
2008-06-17 06:00:00,95.126,434.8,0,109,432,48,59,63,87,53.5,11,75.0,24
2008-06-17 12:00:00,405.344,1722.0,0,107,4710,48,70,40,87,59.0,22,63.5,47
2008-06-17 18:00:00,192.844,886.4000000000001,0,109,1042,70,73,33,41,71.5,3,37.0,8
2008-06-18 00:00:00,451.77,1902.6,1080,107,3910,59,73,31,59,66.0,14,45.0,28
2008-06-18 06:00:00,92.978,427.0,0,106,448,52,63,67,88,57.5,11,77.5,21
2008-06-18 12:00:00,691.894,2989.6,2974,105,6121,54,68,56,88,61.0,14,72.0,32
2008-06-18 18:00:00,493.274,2200.4,3186,2702,465,70,72,41,46,71.0,2,43.5,5
2008-06-19 00:00:00,615.462,2607.4,1389,127,5653,63,68,46,59,65.5,5,52.5,13
2008-06-19 06:00:00,105.034,473.0,0,130,622,55,59,67,82,57.0,4,74.5,15
2008-06-19 12:00:00,503.026,2165.8,1796,115,4192,55,66,72,82,60.5,11,77.0,10
2008-06-19 18:00:00,208.094,923.6,68,518,1019,64,70,68,88,67.0,6,78.0,20
2008-06-20 00:00:00,771.928,3260.2,1547,751,5078,61,66,63,94,63.5,5,78.5,31
2008-06-20 06:00:00,93.192,418.8,0,109,450,57,61,94,100,59.0,4,97.0,6
2008-06-20 12:00:00,605.13,2573.8,840,107,6366,59,68,73,94,63.5,9,83.5,21
2008-06-20 18:00:00,196.902,883.8,582,124,1205,70,73,57,68,71.5,3,62.5,11
2008-06-21 00:00:00,780.88,3335.4,1526,2595,4396,61,73,57,94,67.0,12,75.5,37
2008-06-21 06:00:00,162.074,715.4,0,162,468,57,61,88,100,59.0,4,94.0,12
2008-06-21 12:00:00,354.732,1529.6,0,2205,1986,59,73,61,94,66.0,14,77.5,33
2008-06-21 18:00:00,687.224,2929.4,0,3331,4700,75,81,48,61,78.0,6,54.5,13
2008-06-22 00:00:00,530.224,2218.8,940,125,5674,63,82,51,88,72.5,19,69.5,37
2008-06-22 06:00:00,144.808,637.6,0,139,528,63,66,88,94,64.5,3,91.0,6
2008-06-22 12:00:00,372.638,1625.4,1602,592,1922,64,79,65,100,71.5,15,82.5,35
2008-06-22 18:00:00,476.192,2037.6,2745,122,2909,81,82,58,65,81.5,1,61.5,7
2008-06-23 00:00:00,572.778,2430.0,358,322,5293,68,79,57,83,73.5,11,70.0,26
2008-06-23 06:00:00,146.23000000000002,651.4,0,178,1239,55,63,63,77,59.0,8,70.0,14
2008-06-23 12:00:00,319.684,1363.0,0,118,3759,57,64,56,67,60.5,7,61.5,11
2008-06-23 18:00:00,270.116,1236.4,1000,155,1544,68,73,38,47,70.5,5,42.5,9
2008-06-24 00:00:00,515.766,2209.6,1600,130,3582,63,72,50,73,67.5,9,61.5,23
2008-06-24 06:00:00,112.912,512.8,0,116,510,59,63,72,82,61.0,4,77.0,10
2008-06-24 12:00:00,649.096,2779.2,1386,475,6455,59,75,50,77,67.0,16,63.5,27
2008-06-24 18:00:00,516.068,2243.6,976,2756,2872,77,84,51,58,80.5,7,54.5,7
2008-06-25 00:00:00,476.376,2042.0,417,142,4434,63,82,58,78,72.5,19,68.0,20
2008-06-25 06:00:00,133.132,598.8,438,129,588,68,73,83,94,70.5,5,88.5,11
2008-06-25 12:00:00,358.226,1559.8,0,169,3828,68,73,57,83,70.5,5,70.0,26
2008-06-25 18:00:00,306.15,1435.0,944,128,1853,73,79,42,57,76.0,6,49.5,15
2008-06-26 00:00:00,464.262,2038.2,1391,143,3133,68,75,44,83,71.5,7,63.5,39
2008-06-26 06:00:00,108.166,490.0,0,169,574,57,63,67,72,60.0,6,69.5,5
2008-06-26 12:00:00,440.724,1891.6,0,116,5371,59,70,46,67,64.5,11,56.5,21
2008-06-26 18:00:00,217.728,976.0,921,153,1141,73,77,41,47,75.0,4,44.0,6
2008-06-27 00:00:00,289.402,1266.4,0,134,1885,66,77,41,64,71.5,11,52.5,23
2008-06-27 06:00:00,101.854,452.2000000000001,0,120,563,55,63,63,82,59.0,8,72.5,19
2008-06-27 12:00:00,424.256,1818.2,0,1033,4142,57,68,64,77,62.5,11,70.5,13
2008-06-27 18:00:00,375.738,1648.8000000000002,2507,327,1275,70,72,60,64,71.0,2,62.0,4
2008-06-28 00:00:00,853.304,3621.6,1652,892,4183,66,72,57,68,69.0,6,62.5,11
2008-06-28 06:00:00,107.932,488.4,0,159,472,63,66,73,82,64.5,3,77.5,9
2008-06-28 12:00:00,406.564,1769.0,0,1544,2322,64,70,68,77,67.0,6,72.5,9
2008-06-28 18:00:00,435.982,1869.8,0,130,4652,72,79,51,69,75.5,7,60.0,18
2008-06-29 00:00:00,258.322,1180.6,0,167,486,66,77,54,73,71.5,11,63.5,19
2008-06-29 06:00:00,229.554,1024.8,0,129,1058,64,66,73,83,65.0,2,78.0,10
2008-06-29 12:00:00,104.31,476.2,0,121,471,64,70,60,73,67.0,6,66.5,13
2008-06-29 18:00:00,219.504,966.0,955,156,1186,72,79,47,57,75.5,7,52.0,10
2008-06-30 00:00:00,195.984,889.8,0,129,1181,64,77,50,77,70.5,13,63.5,27
2008-06-30 06:00:00,124.35,555.6,0,121,790,57,68,64,82,62.5,11,73.0,18
2008-06-30 12:00:00,243.52,1058.6,0,127,2542,59,72,50,82,65.5,13,66.0,32
2008-06-30 18:00:00,274.75,1230.8,0,151,2206,72,79,34,50,75.5,7,42.0,16
2008-07-01 00:00:00,161.576,725.0,0,122,1281,68,79,32,64,73.5,11,48.0,32
2008-07-01 06:00:00,104.064,479.4,0,119,605,59,63,63,77,61.0,4,70.0,14
2008-07-01 12:00:00,157.926,705.2,0,132,1363,61,79,47,72,70.0,18,59.5,25
2008-07-01 18:00:00,238.232,1128.2,0,157,1045,81,90,33,48,85.5,9,40.5,15
2008-07-02 00:00:00,715.018,3072.8,3465,179,5377,66,88,33,61,77.0,22,47.0,28
2008-07-02 06:00:00,116.972,552.0,0,140,588,68,75,65,83,71.5,7,74.0,18
2008-07-02 12:00:00,319.348,1535.6,0,194,1605,68,77,61,83,72.5,9,72.0,22
2008-07-02 18:00:00,306.666,1327.2,0,162,2955,68,75,69,94,71.5,7,81.5,25
2008-07-03 00:00:00,404.216,1725.4,962,154,1854,63,77,61,88,70.0,14,74.5,27
2008-07-03 06:00:00,102.352,474.0,0,142,560,59,61,88,94,60.0,2,91.0,6
2008-07-03 12:00:00,295.522,1265.8,0,125,3019,59,66,68,94,62.5,7,81.0,26
2008-07-03 18:00:00,146.95600000000002,678.4,0,127,1061,68,73,38,60,70.5,5,49.0,22
2008-07-04 00:00:00,553.53,2396.0,958,2175,2770,55,64,56,88,59.5,9,72.0,32
2008-07-04 06:00:00,109.052,512.0,0,221,501,48,50,93,100,49.0,2,96.5,7
2008-07-04 12:00:00,297.15000000000003,1274.2,0,124,2805,50,66,52,94,58.0,16,73.0,42
2008-07-04 18:00:00,198.976,864.2,0,122,2062,68,75,36,46,71.5,7,41.0,10
2008-07-05 00:00:00,336.842,1422.4,0,122,2934,54,75,38,82,64.5,21,60.0,44
2008-07-05 06:00:00,127.776,556.8,0,126,506,63,64,59,68,63.5,1,63.5,9
2008-07-05 12:00:00,195.164,864.8,0,434,1311,63,68,68,88,65.5,5,78.0,20
2008-07-05 18:00:00,721.2719999999999,3077.4,981,4709,4247,64,73,53,94,68.5,9,73.5,41
2008-07-06 00:00:00,424.876,1817.6,894,1485,2301,64,72,52,60,68.0,8,56.0,8
2008-07-06 06:00:00,233.548,962.8,0,122,506,54,61,63,82,57.5,7,72.5,19
2008-07-06 12:00:00,303.346,1314.8,0,1824,1680,54,66,60,82,60.0,12,71.0,22
2008-07-06 18:00:00,634.8159999999999,2754.8,3319,1651,1882,68,73,41,56,70.5,5,48.5,15
2008-07-07 00:00:00,633.354,2685.2,939,1633,3468,63,73,36,59,68.0,10,47.5,23
2008-07-07 06:00:00,106.838,494.2,0,193,511,55,61,68,88,58.0,6,78.0,20
2008-07-07 12:00:00,339.186,1438.8,0,158,4112,55,63,68,88,59.0,8,78.0,20
2008-07-07 18:00:00,167.012,729.8,0,120,1114,63,68,56,73,65.5,5,64.5,17
2008-07-08 00:00:00,370.354,1612.0,2171,121,1412,57,64,56,94,60.5,7,75.0,38
2008-07-08 06:00:00,131.154,582.4,0,131,1061,55,57,88,94,56.0,2,91.0,6
2008-07-08 12:00:00,348.536,1465.0,0,140,2158,55,61,68,88,58.0,6,78.0,20
2008-07-08 18:00:00,197.362,886.0,0,116,1536,63,68,56,64,65.5,5,60.0,8
2008-07-09 00:00:00,449.162,1921.4,991,116,2837,57,68,56,94,62.5,11,75.0,38
2008-07-09 06:00:00,94.392,436.6,0,114,436,54,57,88,94,55.5,3,91.0,6
2008-07-09 12:00:00,339.394,1443.4,0,131,3516,54,68,56,94,61.0,14,75.0,38
2008-07-09 18:00:00,136.264,618.6,0,136,1099,68,77,47,56,72.5,9,51.5,9
2008-07-10 00:00:00,349.26800000000003,1497.8,951,118,2301,59,75,53,82,67.0,16,67.5,29
2008-07-10 06:00:00,127.254,567.5999999999999,0,117,1005,59,64,77,88,61.5,5,82.5,11
2008-07-10 12:00:00,427.996,1819.0,0,116,3839,59,75,57,88,67.0,16,72.5,31
2008-07-10 18:00:00,225.812,989.2,0,156,1023,79,81,42,54,80.0,2,48.0,12
2008-07-11 00:00:00,470.214,2014.8,982,163,2319,64,81,45,77,72.5,17,61.0,32
2008-07-11 06:00:00,107.084,499.4,0,140,518,63,66,77,83,64.5,3,80.0,6
2008-07-11 12:00:00,475.178,2036.2,0,164,4383,61,63,82,94,62.0,2,88.0,12
2008-07-11 18:00:00,255.014,1105.4,0,123,2826,66,73,44,83,69.5,7,63.5,39
2008-07-12 00:00:00,416.94,1805.4,724,131,1524,64,73,44,78,68.5,9,61.0,34
2008-07-12 06:00:00,194.424,858.6,938,157,1044,55,61,72,94,58.0,6,83.0,22
2008-07-12 12:00:00,293.018,1261.0,0,499,2906,57,66,56,88,61.5,9,72.0,32
2008-07-12 18:00:00,615.508,2698.8,3498,1484,2295,63,68,43,63,65.5,5,53.0,20
2008-07-13 00:00:00,225.902,1014.2,0,477,986,61,66,52,63,63.5,5,57.5,11
2008-07-13 06:00:00,105.698,523.4,0,124,478,55,59,67,77,57.0,4,72.0,10
2008-07-13 12:00:00,393.162,1677.8,0,1648,2394,55,63,52,77,59.0,8,64.5,25
2008-07-13 18:00:00,411.592,1754.4,624,1273,3068,63,68,40,56,65.5,5,48.0,16
2008-07-14 00:00:00,343.302,1464.4,1047,119,1116,57,68,43,67,62.5,11,55.0,24
2008-07-14 06:00:00,128.596,565.4,445,116,423,57,57,67,67,57.0,0,67.0,0
2008-07-14 12:00:00,321.898,1367.4,0,135,3603,57,57,67,67,57.0,0,67.0,0
2008-07-14 18:00:00,191.704,849.4,0,434,1064,57,57,67,67,57.0,0,67.0,0
2008-07-15 00:00:00,495.728,2159.4,2119,1310,1346,57,57,67,67,57.0,0,67.0,0
2008-07-15 06:00:00,166.22199999999998,736.6,0,136,1437,52,59,67,94,55.5,7,80.5,27
2008-07-15 12:00:00,372.166,1574.2,0,129,4236,54,75,47,94,64.5,21,70.5,47
2008-07-15 18:00:00,374.156,1591.8,968,136,2363,77,82,37,45,79.5,5,41.0,8
2008-07-16 00:00:00,243.316,1044.8,0,151,549,64,81,45,69,72.5,17,57.0,24
2008-07-16 06:00:00,149.42000000000002,663.6,0,137,1045,59,66,73,94,62.5,7,83.5,21
2008-07-16 12:00:00,198.642,878.0,0,126,1455,63,70,56,82,66.5,7,69.0,26
2008-07-16 18:00:00,223.102,959.8,948,128,720,66,72,57,68,69.0,6,62.5,11
2008-07-17 00:00:00,505.898,2159.6,589,2408,1758,66,70,52,73,68.0,4,62.5,21
2008-07-17 06:00:00,145.65,677.8,0,146,808,57,64,56,82,60.5,7,69.0,26
2008-07-17 12:00:00,320.832,1383.2,0,148,3440,57,70,46,82,63.5,13,64.0,36
2008-07-17 18:00:00,334.092,1520.6,1122,213,1035,70,73,38,49,71.5,3,43.5,11
2008-07-18 00:00:00,518.548,2216.8,0,216,2997,64,72,38,56,68.0,8,47.0,18
2008-07-18 06:00:00,181.682,801.2,0,163,1067,59,64,59,72,61.5,5,65.5,13
2008-07-18 12:00:00,380.042,1600.0,0,136,3982,59,68,56,72,63.5,9,64.0,16
2008-07-18 18:00:00,268.386,1145.2,0,136,1094,70,72,49,60,71.0,2,54.5,11
2008-07-19 00:00:00,431.474,1834.8,1143,117,3117,66,70,56,73,68.0,4,64.5,17
2008-07-19 06:00:00,131.60399999999998,581.0,0,118,974,63,66,68,82,64.5,3,75.0,14
2008-07-19 12:00:00,381.57,1676.2,1323,2005,1091,63,68,68,83,65.5,5,75.5,15
2008-07-19 18:00:00,559.318,2365.2,1618,372,5079,68,75,50,73,71.5,7,61.5,23
2008-07-20 00:00:00,271.522,1166.0,0,651,532,64,73,52,68,68.5,9,60.0,16
2008-07-20 06:00:00,233.414,1002.8,883,132,1219,52,61,72,94,56.5,9,83.0,22
2008-07-20 12:00:00,199.256,875.2,0,113,1142,52,66,52,94,59.0,14,73.0,42
2008-07-20 18:00:00,303.58,1316.6,1060,721,1840,68,72,35,46,70.0,4,40.5,11
2008-07-21 00:00:00,205.284,889.8,0,110,1256,61,68,40,64,64.5,7,52.0,24
2008-07-21 06:00:00,95.848,425.4,0,109,429,50,54,77,87,52.0,4,82.0,10
2008-07-21 12:00:00,335.84,1441.2,0,106,3718,52,64,49,88,58.0,12,68.5,39
2008-07-21 18:00:00,328.738,1430.8,0,108,3153,64,70,35,49,67.0,6,42.0,14
2008-07-22 00:00:00,396.052,1716.8,1698,108,1889,57,68,37,63,62.5,11,50.0,26
2008-07-22 06:00:00,96.776,432.6,0,107,471,48,59,63,87,53.5,11,75.0,24
2008-07-22 12:00:00,243.496,1056.6,0,105,2260,50,72,43,87,61.0,22,65.0,44
2008-07-22 18:00:00,193.114,882.0,0,108,989,72,79,26,41,75.5,7,33.5,15
2008-07-23 00:00:00,206.856,901.4,0,110,1166,61,79,26,55,70.0,18,40.5,29
2008-07-23 06:00:00,140.638,620.8,0,110,1171,57,64,56,77,60.5,7,66.5,21
2008-07-23 12:00:00,334.06,1443.4,0,110,3538,59,75,41,72,67.0,16,56.5,31
2008-07-23 18:00:00,161.56799999999998,735.2,0,111,499,75,81,37,41,78.0,6,39.0,4
2008-07-24 00:00:00,306.364,1303.8,1233,123,1117,64,81,34,56,72.5,17,45.0,22
2008-07-24 06:00:00,189.87,805.0,0,131,1209,61,68,49,68,64.5,7,58.5,19
2008-07-24 12:00:00,395.202,1653.2,0,114,4359,61,79,36,68,70.0,18,52.0,32
2008-07-24 18:00:00,147.642,631.6,0,115,517,81,84,25,32,82.5,3,28.5,7
2008-07-25 00:00:00,360.736,1549.2,837,116,2259,70,82,28,46,76.0,12,37.0,18
2008-07-25 06:00:00,111.704,501.6,0,116,641,63,68,56,72,65.5,5,64.0,16
2008-07-25 12:00:00,309.382,1322.4,0,140,3342,64,72,64,78,68.0,8,71.0,14
2008-07-25 18:00:00,106.366,490.8,0,119,568,75,82,42,57,78.5,7,49.5,15
2008-07-26 00:00:00,338.082,1455.6,1168,117,2180,70,79,46,68,74.5,9,57.0,22
2008-07-26 06:00:00,107.23,482.4,0,116,556,61,66,88,100,63.5,5,94.0,12
2008-07-26 12:00:00,284.316,1253.4,0,590,1872,63,73,65,88,68.0,10,76.5,23
2008-07-26 18:00:00,293.288,1263.2,0,125,3016,72,77,57,73,74.5,5,65.0,16
2008-07-27 00:00:00,130.85,593.0,0,117,799,68,77,57,78,72.5,9,67.5,21
2008-07-27 06:00:00,151.05599999999998,669.8,0,115,1165,68,72,68,73,70.0,4,70.5,5
2008-07-27 12:00:00,188.89,843.8,0,135,1432,66,73,65,73,69.5,7,69.0,8
2008-07-27 18:00:00,372.78,1663.4,1063,126,2368,79,84,42,57,81.5,5,49.5,15
2008-07-28 00:00:00,434.67,1881.0,0,482,3420,73,82,42,65,77.5,9,53.5,23
2008-07-28 06:00:00,155.54399999999998,696.4,0,121,1122,66,70,83,94,68.0,4,88.5,11
2008-07-28 12:00:00,289.41,1247.2,0,146,3025,66,79,61,94,72.5,13,77.5,33
2008-07-28 18:00:00,189.832,861.5999999999999,0,121,1171,82,88,37,54,85.0,6,45.5,17
2008-07-29 00:00:00,191.018,901.8,0,121,645,70,88,35,78,79.0,18,56.5,43
2008-07-29 06:00:00,233.114,1065.8,0,150,1333,63,70,78,94,66.5,7,86.0,16
2008-07-29 12:00:00,356.796,1590.4,894,118,2377,63,72,60,88,67.5,9,74.0,28
2008-07-29 18:00:00,194.84,912.8,0,119,583,73,81,42,53,77.0,8,47.5,11
2008-07-30 00:00:00,381.808,1673.8,677,143,1509,68,79,44,78,73.5,11,61.0,34
2008-07-30 06:00:00,201.614,958.0,0,123,969,59,64,77,94,61.5,5,85.5,17
2008-07-30 12:00:00,333.364,1498.2,0,116,2799,59,81,48,94,70.0,22,71.0,46
2008-07-30 18:00:00,176.848,865.0,0,119,574,82,88,37,48,85.0,6,42.5,11
2008-07-31 00:00:00,588.082,2532.6,2548,415,1936,66,88,37,73,77.0,22,55.0,36
2008-07-31 06:00:00,127.17,618.8,0,121,664,66,75,65,88,70.5,9,76.5,23
2008-07-31 12:00:00,403.812,1739.0,0,413,4104,68,82,58,88,75.0,14,73.0,30
2008-07-31 18:00:00,198.09,890.0,0,1274,590,86,93,32,55,89.5,7,43.5,23
2008-08-01 00:00:00,663.566,2846.0,1533,1000,2230,72,88,40,88,80.0,16,64.0,48
2008-08-01 06:00:00,141.348,676.4,0,253,683,63,70,82,88,66.5,7,85.0,6
2008-08-01 12:00:00,351.17,1541.6,586,622,2693,61,70,60,82,65.5,9,71.0,22
2008-08-01 18:00:00,107.31,510.2,0,142,579,70,75,41,56,72.5,5,48.5,15
2008-08-02 00:00:00,139.748,624.0,0,133,1136,66,73,44,83,69.5,7,63.5,39
2008-08-02 06:00:00,102.448,469.8,0,120,556,59,63,72,82,61.0,4,77.0,10
2008-08-02 12:00:00,150.694,677.8,0,131,1319,59,64,82,88,61.5,5,85.0,6
2008-08-02 18:00:00,103.424,479.4,0,135,553,64,75,69,88,69.5,11,78.5,19
2008-08-03 00:00:00,149.21,659.6,0,118,1375,64,77,61,73,70.5,13,67.0,12
2008-08-03 06:00:00,95.544,439.0,0,117,480,63,68,73,88,65.5,5,80.5,15
2008-08-03 12:00:00,155.24,683.6,0,137,1446,63,70,83,94,66.5,7,88.5,11
2008-08-03 18:00:00,98.552,453.8,0,127,533,73,77,61,73,75.0,4,67.0,12
2008-08-04 00:00:00,155.446,694.0,0,118,1467,70,73,64,83,71.5,3,73.5,19
2008-08-04 06:00:00,97.41,455.8,0,118,524,66,68,83,94,67.0,2,88.5,11
2008-08-04 12:00:00,151.92000000000002,674.0,0,129,1397,63,70,64,100,66.5,7,82.0,36
2008-08-04 18:00:00,149.324,688.2,0,634,518,72,75,41,60,73.5,3,50.5,19
2008-08-05 00:00:00,727.266,3099.4,596,3796,1971,68,73,44,83,70.5,5,63.5,39
2008-08-05 06:00:00,162.704,710.2,0,148,744,61,63,77,82,62.0,2,79.5,5
2008-08-05 12:00:00,493.978,2083.8,635,119,5326,63,75,50,82,69.0,12,66.0,32
2008-08-05 18:00:00,91.506,434.6,0,119,530,77,82,42,47,79.5,5,44.5,5
2008-08-06 00:00:00,78.93,380.0,0,123,518,66,81,48,69,73.5,15,58.5,21
2008-08-06 06:00:00,83.98400000000001,405.6,0,145,587,61,70,73,100,65.5,9,86.5,27
2008-08-06 12:00:00,78.122,373.0,0,117,525,61,81,51,94,71.0,20,72.5,43
2008-08-06 18:00:00,80.35000000000001,386.4,0,121,539,84,90,33,45,87.0,6,39.0,12
2008-08-07 00:00:00,83.656,405.2,0,130,564,72,90,33,69,81.0,18,51.0,36
2008-08-07 06:00:00,87.452,420.0,0,148,628,66,73,65,100,69.5,7,82.5,35
2008-08-07 12:00:00,86.39,417.8,0,122,629,66,72,78,94,69.0,6,86.0,16
2008-08-07 18:00:00,80.934,389.0,0,121,556,64,73,65,94,68.5,9,79.5,29
2008-08-08 00:00:00,80.108,387.0,0,135,544,64,77,54,83,70.5,13,68.5,29
2008-08-08 06:00:00,80.39,388.2,0,134,543,61,63,88,100,62.0,2,94.0,12
2008-08-08 12:00:00,73.03,350.2,0,116,467,61,68,73,94,64.5,7,83.5,21
2008-08-08 18:00:00,76.456,362.8,0,115,513,66,72,60,78,69.0,6,69.0,18
2008-08-09 00:00:00,72.324,346.8,0,116,457,63,68,68,82,65.5,5,75.0,14
2008-08-09 06:00:00,75.354,356.6,0,129,509,55,59,88,94,57.0,4,91.0,6
2008-08-09 12:00:00,72.146,345.6,0,128,441,54,68,64,94,61.0,14,79.0,30
2008-08-09 18:00:00,136.442,610.2,0,116,451,68,77,44,64,72.5,9,54.0,20
2008-08-10 00:00:00,74.982,358.40000000000003,0,116,501,59,75,44,88,67.0,16,66.0,44
2008-08-10 06:00:00,72.356,345.2,0,117,461,61,66,64,82,63.5,5,73.0,18
2008-08-10 12:00:00,74.14,351.4,0,114,494,61,68,73,83,64.5,7,78.0,10
2008-08-10 18:00:00,70.658,333.8,0,116,450,68,72,68,73,70.0,4,70.5,5
2008-08-11 00:00:00,134.878,586.0,0,117,500,64,72,64,88,68.0,8,76.0,24
2008-08-11 06:00:00,138.392,586.8,0,126,452,55,59,88,94,57.0,4,91.0,6
2008-08-11 12:00:00,88.924,410.8,0,124,487,57,68,64,88,62.5,11,76.0,24
2008-08-11 18:00:00,70.29,335.2,0,124,441,70,73,46,60,71.5,3,53.0,14
2008-08-12 00:00:00,74.31,353.0,0,115,500,63,72,50,88,67.5,9,69.0,38
2008-08-12 06:00:00,71.446,342.6,0,116,446,61,64,73,94,62.5,3,83.5,21
2008-08-12 12:00:00,72.816,342.6,0,115,496,66,72,64,88,69.0,6,76.0,24
2008-08-12 18:00:00,71.376,340.6,0,115,453,72,75,38,53,73.5,3,45.5,15
2008-08-13 00:00:00,73.346,347.2,0,116,449,64,72,46,73,68.0,8,59.5,27
2008-08-13 06:00:00,69.49,328.8,0,114,443,59,63,68,82,61.0,4,75.0,14
2008-08-13 12:00:00,71.746,340.8,0,113,448,59,68,56,82,63.5,9,69.0,26
2008-08-13 18:00:00,69.356,324.8,0,112,447,68,72,41,56,70.0,4,48.5,15
2008-08-14 00:00:00,71.992,347.0,0,112,451,61,72,41,63,66.5,11,52.0,22
2008-08-14 06:00:00,67.032,320.0,0,111,394,54,57,72,88,55.5,3,80.0,16
2008-08-14 12:00:00,69.038,322.2,0,110,442,52,64,64,88,58.0,12,76.0,24
2008-08-14 18:00:00,68.584,324.6,0,109,421,68,72,43,53,70.0,4,48.0,10
2008-08-15 00:00:00,65.604,307.6,0,111,384,59,72,43,88,65.5,13,65.5,45
2008-08-15 06:00:00,70.0,329.4,0,110,439,57,59,88,94,58.0,2,91.0,6
2008-08-15 12:00:00,68.022,320.0,0,109,436,57,66,60,82,61.5,9,71.0,22
2008-08-15 18:00:00,65.504,311.2,0,109,383,68,72,38,56,70.0,4,47.0,18
2008-08-16 00:00:00,70.128,329.6,0,111,433,59,73,36,88,66.0,14,62.0,52
2008-08-16 06:00:00,68.71,327.0,0,111,435,55,61,68,82,58.0,6,75.0,14
2008-08-16 12:00:00,68.116,321.8,0,109,390,54,72,53,82,63.0,18,67.5,29
2008-08-16 18:00:00,67.30799999999999,312.6,0,110,427,72,73,41,46,72.5,1,43.5,5
2008-08-17 00:00:00,70.68,333.8,0,112,436,63,72,43,64,67.5,9,53.5,21
2008-08-17 06:00:00,70.066,328.0,0,112,446,61,64,68,72,62.5,3,70.0,4
2008-08-17 12:00:00,68.814,323.2,0,110,440,61,68,68,82,64.5,7,75.0,14
2008-08-17 18:00:00,66.384,314.4,0,110,392,68,72,46,64,70.0,4,55.0,18
2008-08-18 00:00:00,69.532,327.2,0,113,432,61,72,43,72,66.5,11,57.5,29
2008-08-18 06:00:00,68.868,323.0,0,109,443,57,61,68,82,59.0,4,75.0,14
2008-08-18 12:00:00,66.754,314.8,0,110,393,59,73,57,88,66.0,14,72.5,31
2008-08-18 18:00:00,68.788,325.0,0,110,439,75,77,53,61,76.0,2,57.0,8
2008-08-19 00:00:00,69.348,325.0,0,111,444,61,75,53,68,68.0,14,60.5,15
2008-08-19 06:00:00,70.576,335.8,0,110,438,59,64,64,88,61.5,5,76.0,24
2008-08-19 12:00:00,68.43,324.2,0,110,435,61,70,60,82,65.5,9,71.0,22
2008-08-19 18:00:00,65.68599999999999,310.8,0,111,385,70,73,50,60,71.5,3,55.0,10
2008-08-20 00:00:00,70.0,330.0,0,111,439,64,68,60,77,66.0,4,68.5,17
2008-08-20 06:00:00,69.276,327.4,0,110,435,59,61,88,88,60.0,2,88.0,0
2008-08-20 12:00:00,65.15,307.4,0,110,383,59,66,68,88,62.5,7,78.0,20
2008-08-20 18:00:00,67.878,323.2,0,109,420,66,72,46,64,69.0,6,55.0,18
2008-08-21 00:00:00,66.168,314.0,0,108,388,61,70,49,88,65.5,9,68.5,39
2008-08-21 06:00:00,64.396,301.4,0,108,387,55,63,72,88,59.0,8,80.0,16
2008-08-21 12:00:00,67.832,317.4,0,106,427,55,68,68,88,61.5,13,78.0,20
2008-08-21 18:00:00,64.952,306.4,0,109,383,68,75,53,68,71.5,7,60.5,15
2008-08-22 00:00:00,64.118,298.40000000000003,0,109,380,64,73,57,88,68.5,9,72.5,31
2008-08-22 06:00:00,69.188,327.4,0,110,431,61,63,94,100,62.0,2,97.0,6
2008-08-22 12:00:00,65.426,307.8,0,109,383,61,63,94,100,62.0,2,97.0,6
2008-08-22 18:00:00,66.30799999999999,311.0,0,108,419,63,63,88,94,63.0,0,91.0,6
2008-08-23 00:00:00,66.202,309.6,0,111,381,59,64,94,94,61.5,5,94.0,0
2008-08-23 06:00:00,64.328,300.4,0,107,374,54,55,94,94,54.5,1,94.0,0
2008-08-23 12:00:00,62.546,293.2,0,105,369,52,64,68,100,58.0,12,84.0,32
2008-08-23 18:00:00,62.91,294.4,0,107,370,66,70,43,60,68.0,4,51.5,17
2008-08-24 00:00:00,64.858,308.4,0,100,372,54,68,46,94,61.0,14,70.0,48
2008-08-24 06:00:00,64.98,300.6,0,92,418,52,55,88,94,53.5,3,91.0,6
2008-08-24 12:00:00,60.51,282.4,0,101,335,54,66,60,88,60.0,12,74.0,28
2008-08-24 18:00:00,64.266,302.4,0,104,384,57,64,68,94,60.5,7,81.0,26
2008-08-25 00:00:00,64.96,304.6,0,107,386,55,64,77,88,59.5,9,82.5,11
2008-08-25 06:00:00,63.61,296.2,0,106,379,55,59,82,100,57.0,4,91.0,18
2008-08-25 12:00:00,61.282,286.0,0,105,337,57,66,68,94,61.5,9,81.0,26
2008-08-25 18:00:00,64.154,296.4,0,105,385,68,73,50,60,70.5,5,55.0,10
2008-08-26 00:00:00,61.252,285.4,0,106,335,61,70,60,94,65.5,9,77.0,34
2008-08-26 06:00:00,62.744,290.2,0,105,380,57,66,78,94,61.5,9,86.0,16
2008-08-26 12:00:00,65.638,307.2,0,105,388,57,68,73,94,62.5,11,83.5,21
2008-08-26 18:00:00,64.81,303.8,0,106,391,68,75,57,73,71.5,7,65.0,16
2008-08-27 00:00:00,64.372,304.4,0,104,374,64,73,65,83,68.5,9,74.0,18
2008-08-27 06:00:00,62.894,290.6,0,94,383,54,59,88,100,56.5,5,94.0,12
2008-08-27 12:00:00,64.826,301.2,0,93,385,57,66,68,100,61.5,9,84.0,32
2008-08-27 18:00:00,64.81400000000001,302.2,0,105,381,70,73,57,64,71.5,3,60.5,7
2008-08-28 00:00:00,65.58,305.8,0,107,390,61,73,61,88,67.0,12,74.5,27
2008-08-28 06:00:00,67.424,311.6,0,107,431,59,63,77,88,61.0,4,82.5,11
2008-08-28 12:00:00,66.078,313.4,0,107,387,61,66,68,82,63.5,5,75.0,14
2008-08-28 18:00:00,66.844,315.8,0,107,397,66,68,64,73,67.0,2,68.5,9
2008-08-29 00:00:00,67.9,319.2,0,111,416,63,66,68,82,64.5,3,75.0,14
2008-08-29 06:00:00,64.82000000000001,305.0,0,107,382,63,64,73,82,63.5,1,77.5,9
2008-08-29 12:00:00,65.154,303.8,0,107,387,63,64,73,82,63.5,1,77.5,9
2008-08-29 18:00:00,64.96,306.0,0,107,387,66,72,64,73,69.0,6,68.5,9
2008-08-30 00:00:00,72.654,345.2,0,109,443,63,72,60,82,67.5,9,71.0,22
2008-08-30 06:00:00,65.934,312.2,0,107,385,57,61,88,94,59.0,4,91.0,6
2008-08-30 12:00:00,66.586,313.8,0,108,392,59,73,65,88,66.0,14,76.5,23
2008-08-30 18:00:00,65.56,305.2,0,109,398,75,84,45,69,79.5,9,57.0,24
2008-08-31 00:00:00,72.344,345.0,0,111,444,61,84,45,88,72.5,23,66.5,43
2008-08-31 06:00:00,71.776,341.0,0,111,464,61,66,83,94,63.5,5,88.5,11
2008-08-31 12:00:00,69.83,329.4,0,107,446,66,73,61,83,69.5,7,72.0,22
2008-08-31 18:00:00,563.802,2391.8,682,2241,4446,75,81,54,69,78.0,6,61.5,15
2008-09-01 00:00:00,795.206,3341.8,1374,1274,6761,66,77,54,78,71.5,11,66.0,24
2008-09-01 06:00:00,141.09,626.4,0,168,1004,59,64,82,88,61.5,5,85.0,6
2008-09-01 12:00:00,542.82,2299.4,950,112,5268,61,64,77,88,62.5,3,82.5,11
2008-09-01 18:00:00,273.076,1209.4,0,121,2298,68,72,53,68,70.0,4,60.5,15
2008-09-02 00:00:00,290.524,1239.6,0,120,1613,59,70,56,88,64.5,11,72.0,32
2008-09-02 06:00:00,109.714,497.8,0,117,448,59,61,77,88,60.0,2,82.5,11
2008-09-02 12:00:00,336.722,1442.4,0,384,3380,59,68,73,88,63.5,9,80.5,15
2008-09-02 18:00:00,352.224,1516.2,2233,142,1683,66,72,64,83,69.0,6,73.5,19
2008-09-03 00:00:00,585.494,2507.4,2040,563,1137,55,68,77,94,61.5,13,85.5,17
2008-09-03 06:00:00,142.14,624.4,0,110,1108,52,54,94,94,53.0,2,94.0,0
2008-09-03 12:00:00,469.174,1990.8,0,1484,4084,54,57,88,94,55.5,3,91.0,6
2008-09-03 18:00:00,371.284,1560.2,367,199,3672,57,61,77,94,59.0,4,85.5,17
2008-09-04 00:00:00,405.888,1755.4,959,109,1349,54,59,77,94,56.5,5,85.5,17
2008-09-04 06:00:00,130.054,565.2,0,108,991,52,55,94,94,53.5,3,94.0,0
2008-09-04 12:00:00,366.094,1543.2,0,106,4292,50,61,77,94,55.5,11,85.5,17
2008-09-04 18:00:00,271.32,1183.4,0,96,2756,63,66,59,72,64.5,3,65.5,13
2008-09-05 00:00:00,457.752,1971.0,2225,94,1369,54,64,64,94,59.0,10,79.0,30
2008-09-05 06:00:00,90.87,400.8,0,106,395,57,57,94,94,57.0,0,94.0,0
2008-09-05 12:00:00,436.186,1840.6,0,107,4715,57,61,94,94,59.0,4,94.0,0
2008-09-05 18:00:00,88.23400000000001,400.6,0,109,403,66,68,78,83,67.0,2,80.5,5
2008-09-06 00:00:00,258.67,1110.0,379,109,1430,57,68,68,94,62.5,11,81.0,26
2008-09-06 06:00:00,133.576,574.0,0,110,1139,61,64,68,82,62.5,3,75.0,14
2008-09-06 12:00:00,633.134,2686.2,1023,3537,3556,59,64,59,88,61.5,5,73.5,29
2008-09-06 18:00:00,492.428,2128.0,817,2691,2741,64,70,43,64,67.0,6,53.5,21
2008-09-07 00:00:00,609.436,2567.0,1108,162,5964,63,68,46,73,65.5,5,59.5,27
2008-09-07 06:00:00,120.16,520.2,0,95,457,57,61,68,94,59.0,4,81.0,26
2008-09-07 12:00:00,185.754,808.8,0,93,1295,57,63,72,94,60.0,6,83.0,22
2008-09-07 18:00:00,558.092,2374.0,2655,1425,2501,63,66,64,72,64.5,3,68.0,8
2008-09-08 00:00:00,508.65,2173.4,957,94,1723,61,64,68,72,62.5,3,70.0,4
2008-09-08 06:00:00,102.656,456.8,0,103,492,54,59,82,94,56.5,5,88.0,12
2008-09-08 12:00:00,536.794,2237.8,0,103,6573,54,61,77,100,57.5,7,88.5,23
2008-09-08 18:00:00,137.244,591.6,0,92,1157,64,70,43,68,67.0,6,55.5,25
2008-09-09 00:00:00,532.63,2262.6,747,1995,1337,57,70,46,77,63.5,13,61.5,31
2008-09-09 06:00:00,157.054,680.2,236,168,1163,52,55,77,88,53.5,3,82.5,11
2008-09-09 12:00:00,494.87,2119.2,0,97,3976,52,73,53,88,62.5,21,70.5,35
2008-09-09 18:00:00,223.608,981.4,0,95,1502,68,81,42,83,74.5,13,62.5,41
2008-09-10 00:00:00,284.122,1208.0,0,93,1087,55,70,73,88,62.5,15,80.5,15
2008-09-10 06:00:00,102.62,455.4,0,104,496,61,64,94,100,62.5,3,97.0,6
2008-09-10 12:00:00,605.386,2556.6,1009,105,6064,61,68,83,94,64.5,7,88.5,11
2008-09-10 18:00:00,243.14,1061.8,0,95,2329,70,77,54,78,73.5,7,66.0,24
2008-09-11 00:00:00,349.618,1481.0,0,95,1392,64,77,50,94,70.5,13,72.0,44
2008-09-11 06:00:00,100.468,453.2000000000001,0,118,509,59,61,94,100,60.0,2,97.0,6
2008-09-11 12:00:00,425.64,1819.4,0,95,4771,61,75,69,100,68.0,14,84.5,31
2008-09-11 18:00:00,206.106,903.8,1005,99,1113,75,81,57,65,78.0,6,61.0,8
2008-09-12 00:00:00,296.5,1259.2,0,105,1251,59,68,78,94,63.5,9,86.0,16
2008-09-12 06:00:00,135.512,593.8,0,112,1099,57,57,88,94,57.0,0,91.0,6
2008-09-12 12:00:00,543.5,2322.4,950,94,4990,55,63,77,94,59.0,8,85.5,17
2008-09-12 18:00:00,128.416,582.6,0,96,499,63,66,56,68,64.5,3,62.0,12
2008-09-13 00:00:00,585.334,2469.4,917,100,2150,52,63,72,88,57.5,11,80.0,16
2008-09-13 06:00:00,111.518,499.2000000000001,0,106,492,46,50,93,100,48.0,4,96.5,7
2008-09-13 12:00:00,615.1,2592.2,0,1807,6252,46,61,68,100,53.5,15,84.0,32
2008-09-13 18:00:00,570.336,2420.8,930,2273,3862,63,64,56,63,63.5,1,59.5,7
2008-09-14 00:00:00,334.482,1428.8,0,1247,1201,52,61,68,88,56.5,9,78.0,20
2008-09-14 06:00:00,173.93200000000002,747.2,0,127,1104,54,59,82,88,56.5,5,85.0,6
2008-09-14 12:00:00,258.32,1137.4,857,95,815,55,61,55,88,58.0,6,71.5,33
2008-09-14 18:00:00,602.888,2595.8,2896,106,2763,63,66,37,52,64.5,3,44.5,15
2008-09-15 00:00:00,541.186,2338.0,920,117,1856,55,64,45,77,59.5,9,61.0,32
2008-09-15 06:00:00,204.086,941.8,0,92,1029,46,55,71,87,50.5,9,79.0,16
2008-09-15 12:00:00,529.7860000000001,2253.8,0,90,5340,45,61,55,93,53.0,16,74.0,38
2008-09-15 18:00:00,286.052,1253.2,0,92,1202,61,64,45,55,62.5,3,50.0,10
2008-09-16 00:00:00,677.784,2854.6,960,90,2751,55,59,59,77,57.0,4,68.0,18
2008-09-16 06:00:00,105.026,468.0,0,92,441,48,52,67,82,50.0,4,74.5,15
2008-09-16 12:00:00,474.786,1990.4,0,89,4775,46,59,55,87,52.5,13,71.0,32
2008-09-16 18:00:00,255.18,1110.6,0,90,1459,61,64,42,52,62.5,3,47.0,10
2008-09-17 00:00:00,386.87,1642.8,0,97,1574,54,61,48,67,57.5,7,57.5,19
2008-09-17 06:00:00,131.924,574.4,0,100,1045,46,52,71,87,49.0,6,79.0,16
2008-09-17 12:00:00,590.806,2493.4,1164,892,5297,48,57,48,82,52.5,9,65.0,34
2008-09-17 18:00:00,329.444,1419.0,746,2640,396,59,61,42,45,60.0,2,43.5,3
2008-09-18 00:00:00,467.036,1978.4,0,95,2633,52,59,48,67,55.5,7,57.5,19
2008-09-18 06:00:00,96.284,427.4,0,90,449,46,50,66,76,48.0,4,71.0,10
2008-09-18 12:00:00,496.656,2097.2,1002,88,4059,45,52,67,81,48.5,7,74.0,14
2008-09-18 18:00:00,235.628,1019.4,0,90,1763,54,61,51,62,57.5,7,56.5,11
2008-09-19 00:00:00,676.722,2860.2,3200,89,1720,50,61,55,82,55.5,11,68.5,27
2008-09-19 06:00:00,160.028,686.6,563,88,908,43,46,87,93,44.5,3,90.0,6
2008-09-19 12:00:00,532.588,2278.6,0,86,5547,45,59,51,93,52.0,14,72.0,42
2008-09-19 18:00:00,225.36,958.0,0,89,1884,63,66,34,42,64.5,3,38.0,8
2008-09-20 00:00:00,600.87,2526.2000000000003,1006,88,4028,50,63,42,82,56.5,13,62.0,40
2008-09-20 06:00:00,283.88,1173.2,0,87,1162,46,54,67,82,50.0,8,74.5,15
2008-09-20 12:00:00,490.75,2053.6,0,93,5846,45,61,52,87,53.0,16,69.5,35
2008-09-20 18:00:00,368.436,1548.4,0,96,4375,64,66,35,42,65.0,2,38.5,7
2008-09-21 00:00:00,161.534,704.8,0,94,1094,52,63,42,71,57.5,11,56.5,29
2008-09-21 06:00:00,109.132,483.0,0,87,460,45,52,67,81,48.5,7,74.0,14
2008-09-21 12:00:00,297.354,1297.1999999999998,706,522,1959,45,59,48,81,52.0,14,64.5,33
2008-09-21 18:00:00,609.71,2596.4,2174,1674,3184,61,64,37,42,62.5,3,39.5,5
2008-09-22 00:00:00,516.874,2190.2,1130,98,2744,55,63,42,58,59.0,8,50.0,16
2008-09-22 06:00:00,126.086,546.4,0,108,895,46,50,71,87,48.0,4,79.0,16
2008-09-22 12:00:00,534.92,2240.4,0,97,6303,46,59,72,87,52.5,13,79.5,15
2008-09-22 18:00:00,167.406,727.6,0,93,1621,61,64,48,63,62.5,3,55.5,15
2008-09-23 00:00:00,530.152,2263.8,1014,2150,1408,54,61,48,67,57.5,7,57.5,19
2008-09-23 06:00:00,142.938,622.8000000000001,0,136,1181,46,52,71,87,49.0,6,79.0,16
2008-09-23 12:00:00,531.9159999999999,2270.4,0,1789,4076,46,59,67,93,52.5,13,80.0,26
2008-09-23 18:00:00,144.456,679.8000000000001,0,151,408,59,63,55,67,61.0,4,61.0,12
2008-09-24 00:00:00,413.478,1732.2,0,92,2255,54,59,67,77,56.5,5,72.0,10
2008-09-24 06:00:00,153.74,639.6,0,90,461,52,55,82,100,53.5,3,91.0,18
2008-09-24 12:00:00,637.0120000000001,2657.8,1015,327,6448,52,59,72,100,55.5,7,86.0,28
2008-09-24 18:00:00,441.074,1898.2,0,4140,1718,61,64,52,68,62.5,3,60.0,16
2008-09-25 00:00:00,486.524,2050.0,1004,173,1921,54,61,63,82,57.5,7,72.5,19
2008-09-25 06:00:00,100.276,451.2,0,199,460,52,55,82,88,53.5,3,85.0,6
2008-09-25 12:00:00,466.076,1952.0,0,199,5346,55,59,77,88,57.0,4,82.5,11
2008-09-25 18:00:00,99.012,447.6,0,198,435,64,66,46,59,65.0,2,52.5,13
2008-09-26 00:00:00,465.856,1964.2,1012,155,2244,54,63,52,82,58.5,9,67.0,30
2008-09-26 06:00:00,92.432,410.2,0,94,459,48,54,82,87,51.0,6,84.5,5
2008-09-26 12:00:00,510.946,2142.8,0,91,6004,46,59,63,87,52.5,13,75.0,24
2008-09-26 18:00:00,236.5,1030.0,0,93,1909,63,66,35,52,64.5,3,43.5,17
2008-09-27 00:00:00,591.572,2522.0,1221,92,2518,54,64,40,82,59.0,10,61.0,42
2008-09-27 06:00:00,91.412,409.2,0,91,404,48,52,67,76,50.0,4,71.5,9
2008-09-27 12:00:00,508.802,2153.8,1086,976,4215,46,63,45,81,54.5,17,63.0,36
2008-09-27 18:00:00,388.916,1626.6,0,1424,3019,64,68,28,40,66.0,4,34.0,12
2008-09-28 00:00:00,1138.316,4822.8,3261,93,5050,52,64,37,71,58.0,12,54.0,34
2008-09-28 06:00:00,385.21,1633.4,903,103,984,45,54,67,87,49.5,9,77.0,20
2008-09-28 12:00:00,211.74,930.4,0,97,1563,45,61,59,87,53.0,16,73.0,28
2008-09-28 18:00:00,534.9879999999999,2214.6,0,94,6506,64,68,37,49,66.0,4,43.0,12
2008-09-29 00:00:00,599.1659999999999,2536.2,1017,91,2189,50,64,45,82,57.0,14,63.5,37
2008-09-29 06:00:00,162.506,694.4000000000001,0,90,1066,41,46,87,100,43.5,5,93.5,13
2008-09-29 12:00:00,582.942,2451.0,0,91,5835,41,59,72,100,50.0,18,86.0,28
2008-09-29 18:00:00,263.96,1142.2,0,91,1953,63,64,49,63,63.5,1,56.0,14
2008-09-30 00:00:00,492.33,2062.0,1014,91,1823,50,61,59,87,55.5,11,73.0,28
2008-09-30 06:00:00,124.81,527.8,0,89,405,46,48,87,87,47.0,2,87.0,0
2008-09-30 12:00:00,475.806,1991.4,0,89,4452,48,52,87,94,50.0,4,90.5,7
2008-09-30 18:00:00,126.806,547.8,0,91,403,54,57,77,88,55.5,3,82.5,11
2008-10-01 00:00:00,647.584,2728.6,998,91,2155,50,57,76,88,53.5,7,82.0,12
2008-10-01 06:00:00,133.954,580.2,0,92,617,55,55,82,82,55.0,0,82.0,0
2008-10-01 12:00:00,686.4359999999999,2873.0,1226,267,6414,55,63,72,82,59.0,8,77.0,10
2008-10-01 18:00:00,513.872,2181.4,1,5028,1681,59,64,59,77,61.5,5,68.0,18
2008-10-02 00:00:00,538.102,2259.6,1022,413,2096,50,59,63,82,54.5,9,72.5,19
2008-10-02 06:00:00,159.76,687.8000000000001,0,93,1023,50,54,72,82,52.0,4,77.0,10
2008-10-02 12:00:00,600.986,2538.2,0,92,5332,48,57,59,87,52.5,9,73.0,28
2008-10-02 18:00:00,157.94,679.6,0,92,1046,54,61,44,72,57.5,7,58.0,28
2008-10-03 00:00:00,426.656,1780.4,0,90,1659,43,52,76,87,47.5,9,81.5,11
2008-10-03 06:00:00,126.864,535.2,0,89,397,43,45,87,87,44.0,2,87.0,0
2008-10-03 12:00:00,624.0459999999999,2649.0,1003,87,5771,43,50,76,93,46.5,7,84.5,17
2008-10-03 18:00:00,158.552,667.6,0,88,977,48,52,71,82,50.0,4,76.5,11
2008-10-04 00:00:00,703.1179999999999,2982.0,3798,85,2287,43,48,76,87,45.5,5,81.5,11
2008-10-04 06:00:00,632.264,2680.2,2446,64,4705,39,43,87,93,41.0,4,90.0,6
2008-10-04 12:00:00,468.12,1976.4,1016,373,2676,37,52,71,100,44.5,15,85.5,29
2008-10-04 18:00:00,720.008,3025.8,0,98,4795,54,59,42,67,56.5,5,54.5,25
2008-10-05 00:00:00,280.104,1166.2,0,94,397,45,55,47,87,50.0,10,67.0,40
2008-10-05 06:00:00,338.402,1440.4,506,1438,1230,52,52,67,76,52.0,0,71.5,9
2008-10-05 12:00:00,458.506,1918.6,484,1586,1307,50,54,72,88,52.0,4,80.0,16
2008-10-05 18:00:00,616.18,2584.2,0,119,3047,55,57,67,88,56.0,2,77.5,21
2008-10-06 00:00:00,136.862,586.0,0,114,487,54,61,62,88,57.5,7,75.0,26
2008-10-06 06:00:00,619.948,2612.6,990,113,6444,57,61,88,88,59.0,4,88.0,0
2008-10-06 12:00:00,126.912,546.8,0,57,382,57,63,72,88,60.0,6,80.0,16
2008-10-06 18:00:00,137.842,612.6,0,28,362,63,64,64,72,63.5,1,68.0,8
2008-10-07 00:00:00,539.08,2299.6,0,88,2374,57,61,72,88,59.0,4,80.0,16
2008-10-07 06:00:00,192.578,870.4,0,108,454,57,59,88,100,58.0,2,94.0,12
2008-10-07 12:00:00,645.6800000000001,2781.8,0,97,5660,59,64,83,94,61.5,5,88.5,11
2008-10-07 18:00:00,274.198,1194.8,0,101,1822,68,72,53,73,70.0,4,63.0,20
2008-10-08 00:00:00,614.112,2592.2,1016,113,1540,57,64,73,94,60.5,7,83.5,21
2008-10-08 06:00:00,131.6,555.4,0,87,405,54,57,94,94,55.5,3,94.0,0
2008-10-08 12:00:00,603.5260000000001,2525.6,0,131,6573,52,57,82,94,54.5,5,88.0,12
2008-10-08 18:00:00,525.784,2235.6,0,4751,2037,59,61,59,77,60.0,2,68.0,18
2008-10-09 00:00:00,599.6659999999999,2504.4,1044,157,2635,55,59,63,94,57.0,4,78.5,31
2008-10-09 06:00:00,127.626,537.6,0,93,392,48,52,88,94,50.0,4,91.0,6
2008-10-09 12:00:00,910.628,3873.2,0,2727,6238,48,55,82,100,51.5,7,91.0,18
2008-10-09 18:00:00,436.73,1822.4,0,142,2758,59,61,52,67,60.0,2,59.5,15
2008-10-10 00:00:00,508.698,2136.6,1032,102,2264,46,57,63,87,51.5,11,75.0,24
2008-10-10 06:00:00,150.014,641.8,0,89,787,41,43,93,100,42.0,2,96.5,7
2008-10-10 12:00:00,618.968,2609.0,0,107,5868,41,59,77,100,50.0,18,88.5,23
2008-10-10 18:00:00,353.866,1483.8,0,83,4154,63,68,56,68,65.5,5,62.0,12
2008-10-11 00:00:00,395.49,1654.4,0,110,1237,45,63,72,94,54.0,18,83.0,22
2008-10-11 06:00:00,176.072,747.0,0,90,1185,46,52,93,100,49.0,6,96.5,7
2008-10-11 12:00:00,496.996,2111.6,646,514,4086,45,50,93,100,47.5,5,96.5,7
2008-10-11 18:00:00,424.574,1811.2,1491,1566,1670,54,66,68,100,60.0,12,84.0,32
2008-10-12 00:00:00,571.744,2394.8,7,165,4432,54,63,77,88,58.5,9,82.5,11
2008-10-12 06:00:00,175.004,735.2,0,106,976,48,54,93,100,51.0,6,96.5,7
2008-10-12 12:00:00,371.614,1564.0,1016,118,1118,45,63,77,100,54.0,18,88.5,23
2008-10-12 18:00:00,318.07,1317.0,0,121,3056,66,72,53,68,69.0,6,60.5,15
2008-10-13 00:00:00,1043.252,4469.6,1545,5477,2021,52,64,68,94,58.0,12,81.0,26
2008-10-13 06:00:00,163.884,688.2,0,173,989,54,55,88,100,54.5,1,94.0,12
2008-10-13 12:00:00,665.282,2765.8,1037,127,6296,55,68,73,94,61.5,13,83.5,21
2008-10-13 18:00:00,184.304,788.4,0,126,864,72,77,50,69,74.5,5,59.5,19
2008-10-14 00:00:00,448.506,1883.8,0,109,1334,57,70,60,82,63.5,13,71.0,22
2008-10-14 06:00:00,173.024,726.8000000000001,0,108,1195,57,57,82,82,57.0,0,82.0,0
2008-10-14 12:00:00,610.514,2586.8,0,106,5867,55,59,77,94,57.0,4,85.5,17
2008-10-14 18:00:00,267.58,1135.0,0,107,1732,61,64,59,72,62.5,3,65.5,13
2008-10-15 00:00:00,557.938,2362.8,1177,121,1145,59,59,72,77,59.0,0,74.5,5
2008-10-15 06:00:00,185.22,780.2,0,129,1097,55,57,82,88,56.0,2,85.0,6
2008-10-15 12:00:00,718.096,3025.6000000000004,967,404,6364,57,61,77,88,59.0,4,82.5,11
2008-10-15 18:00:00,596.808,2539.2,0,5739,462,59,63,77,94,61.0,4,85.5,17
2008-10-16 00:00:00,656.772,2767.6,1031,770,2061,57,61,77,94,59.0,4,85.5,17
2008-10-16 06:00:00,146.368,630.2,0,113,444,54,55,82,88,54.5,1,85.0,6
2008-10-16 12:00:00,640.748,2702.6,632,106,5660,54,57,88,88,55.5,3,88.0,0
2008-10-16 18:00:00,312.552,1341.8,319,107,554,54,57,51,82,55.5,3,66.5,31
2008-10-17 00:00:00,484.012,2037.6,0,103,1780,43,55,58,88,49.0,12,73.0,30
2008-10-17 06:00:00,149.164,635.6,0,103,486,39,41,93,100,40.0,2,96.5,7
2008-10-17 12:00:00,712.09,2982.4,1040,98,6648,39,55,72,100,47.0,16,86.0,28
2008-10-17 18:00:00,157.498,676.4,0,103,387,57,59,42,59,58.0,2,50.5,17
2008-10-18 00:00:00,848.134,3590.8,996,2883,2118,43,52,62,93,47.5,9,77.5,31
2008-10-18 06:00:00,163.15,684.6,0,101,1055,36,41,93,100,38.5,5,96.5,7
2008-10-18 12:00:00,654.128,2735.6,0,1343,5721,36,54,67,100,45.0,18,83.5,33
2008-10-18 18:00:00,260.346,1101.8,0,102,875,57,61,42,59,59.0,4,50.5,17
2008-10-19 00:00:00,1161.566,4905.8,799,109,4495,41,52,58,93,46.5,11,75.5,35
2008-10-19 06:00:00,795.93,3380.4,698,2985,1649,37,39,93,100,38.0,2,96.5,7
2008-10-19 12:00:00,446.728,1889.4,0,3147,1565,36,52,71,100,44.0,16,85.5,29
2008-10-19 18:00:00,240.05,1025.2,0,1728,389,57,61,42,59,59.0,4,50.5,17
2008-10-20 00:00:00,489.226,2064.6,0,150,997,41,54,58,93,47.5,13,75.5,35
2008-10-20 06:00:00,160.856,672.4,0,100,996,41,45,87,100,43.0,4,93.5,13
2008-10-20 12:00:00,620.172,2575.4,844,100,6231,45,61,72,93,53.0,16,82.5,21
2008-10-20 18:00:00,278.42,1171.4,0,104,1830,63,68,52,72,65.5,5,62.0,20
2008-10-21 00:00:00,608.106,2579.6,0,2344,1418,41,66,60,93,53.5,25,76.5,33
2008-10-21 06:00:00,206.96,892.5999999999999,0,178,1239,57,61,77,88,59.0,4,82.5,11
2008-10-21 12:00:00,769.988,3273.4,0,570,5556,52,54,88,94,53.0,2,91.0,6
2008-10-21 18:00:00,321.126,1351.6,0,105,2794,50,54,87,94,52.0,4,90.5,7
2008-10-22 00:00:00,765.642,3238.8,857,1810,1742,48,61,77,94,54.5,13,85.5,17
2008-10-22 06:00:00,166.31,692.6,0,104,1088,45,48,93,100,46.5,3,96.5,7
2008-10-22 12:00:00,469.688,1973.0,0,101,4424,45,52,71,93,48.5,7,82.0,22
2008-10-22 18:00:00,466.292,2011.6,0,2198,1047,54,57,51,67,55.5,3,59.0,16
2008-10-23 00:00:00,543.72,2288.0,662,139,1928,41,50,76,94,45.5,9,85.0,18
2008-10-23 06:00:00,150.89600000000002,638.2,0,96,828,37,39,93,100,38.0,2,96.5,7
2008-10-23 12:00:00,806.502,3368.6,815,421,6201,36,52,76,100,44.0,16,88.0,24
2008-10-23 18:00:00,346.462,1500.6,0,101,2204,54,57,51,67,55.5,3,59.0,16
2008-10-24 00:00:00,526.634,2232.0,0,817,1354,41,52,62,93,46.5,11,77.5,31
2008-10-24 06:00:00,167.89999999999998,701.6,0,136,1133,43,45,76,87,44.0,2,81.5,11
2008-10-24 12:00:00,595.806,2490.4,833,285,5703,43,50,76,87,46.5,7,81.5,11
2008-10-24 18:00:00,253.364,1065.8,210,100,1824,52,55,63,71,53.5,3,67.0,8
2008-10-25 00:00:00,1116.156,4766.6,6850,1756,1624,41,54,67,87,47.5,13,77.0,20
2008-10-25 06:00:00,168.666,717.4,0,99,668,48,52,82,94,50.0,4,88.0,12
2008-10-25 12:00:00,550.986,2306.0,0,102,4536,48,50,87,100,49.0,2,93.5,13
2008-10-25 18:00:00,590.6759999999999,2446.4,737,96,6379,52,54,88,94,53.0,2,91.0,6
2008-10-26 00:00:00,212.828,893.2,0,97,1850,45,52,82,100,48.5,7,91.0,18
2008-10-26 06:00:00,135.586,552.6,0,64,605,41,45,93,100,43.0,4,96.5,7
2008-10-26 12:00:00,126.0,520.4,0,97,414,45,48,93,100,46.5,3,96.5,7
2008-10-26 18:00:00,161.46,668.4,0,99,994,52,59,67,100,55.5,7,83.5,33
2008-10-27 00:00:00,116.898,484.6,0,109,0,45,59,67,93,52.0,14,80.0,26
2008-10-27 06:00:00,160.812,661.0,0,100,997,54,55,82,100,54.5,1,91.0,18
2008-10-27 12:00:00,100.936,422.6,0,100,0,50,54,82,100,52.0,4,91.0,18
2008-10-27 18:00:00,160.374,663.6,0,102,970,50,57,63,82,53.5,7,72.5,19
2008-10-28 00:00:00,101.77,426.0,0,100,0,43,48,87,93,45.5,5,90.0,6
2008-10-28 06:00:00,159.58200000000002,654.8,0,99,972,41,43,93,93,42.0,2,93.0,0
2008-10-28 12:00:00,101.208,421.8,0,96,0,41,46,81,93,43.5,5,87.0,12
2008-10-28 18:00:00,156.996,649.0,0,82,946,48,52,58,71,50.0,4,64.5,13
2008-10-29 00:00:00,909.504,3823.0,2263,85,3172,37,45,71,93,41.0,8,82.0,22
2008-10-29 06:00:00,615.7439999999999,2551.0,1037,95,1152,0,36,93,100,18.0,36,96.5,7
2008-10-29 12:00:00,355.694,1456.2,0,94,1216,0,34,93,100,17.0,34,96.5,7
2008-10-29 18:00:00,339.01,1379.8,0,93,1075,36,39,93,100,37.5,3,96.5,7
2008-10-30 00:00:00,302.128,1243.2,0,63,572,37,39,93,100,38.0,2,96.5,7
2008-10-30 06:00:00,314.222,1281.2,0,95,706,36,39,93,100,37.5,3,96.5,7
2008-10-30 12:00:00,273.286,1127.6,0,93,4,36,39,87,100,37.5,3,93.5,13
2008-10-30 18:00:00,275.384,1205.2,0,64,1566,39,43,76,93,41.0,4,84.5,17
2008-10-31 00:00:00,235.708,1099.6,0,93,343,39,41,93,100,40.0,2,96.5,7
2008-10-31 06:00:00,135.286,564.0,0,63,429,41,41,93,100,41.0,0,96.5,7
2008-10-31 12:00:00,201.314,854.8,0,93,1030,41,45,93,100,43.0,4,96.5,7
2008-10-31 18:00:00,621.5840000000001,2575.4,0,94,6495,45,46,87,100,45.5,1,93.5,13
2008-11-01 00:00:00,327.648,1429.4,0,62,2529,0,45,0,93,22.5,45,46.5,93
2008-11-01 06:00:00,177.792,825.4000000000001,0,93,0,0,0,0,0,0.0,0,0.0,0
2008-11-01 12:00:00,235.756,1058.6,0,76,979,0,50,0,100,25.0,50,50.0,100
2008-11-01 18:00:00,237.604,1062.0,0,81,960,50,52,88,100,51.0,2,94.0,12
2008-11-02 00:00:00,179.346,835.0,0,94,0,48,52,71,82,50.0,4,76.5,11
2008-11-02 06:00:00,236.73,1056.4,0,87,953,46,48,76,87,47.0,2,81.5,11
2008-11-02 12:00:00,176.94,826.2,0,68,0,43,50,76,93,46.5,7,84.5,17
2008-11-02 18:00:00,260.412,1164.0,0,97,928,50,54,67,82,52.0,4,74.5,15
2008-11-03 00:00:00,236.532,1077.6,0,94,943,48,50,82,87,49.0,2,84.5,5
2008-11-03 06:00:00,175.432,822.4,0,62,0,46,48,87,100,47.0,2,93.5,13
2008-11-03 12:00:00,235.208,1060.4,0,94,951,45,54,88,100,49.5,9,94.0,12
2008-11-03 18:00:00,206.34,958.0,20,96,0,55,63,59,77,59.0,8,68.0,18
2008-11-04 00:00:00,230.62,996.8,943,95,941,48,54,76,87,51.0,6,81.5,11
2008-11-04 06:00:00,117.59,523.0,0,87,0,37,48,87,100,42.5,11,93.5,13
2008-11-04 12:00:00,174.512,756.4,0,68,960,39,54,82,100,46.5,15,91.0,18
2008-11-04 18:00:00,260.856,1112.4,0,95,912,57,63,55,72,60.0,6,63.5,17
2008-11-05 00:00:00,1009.358,4307.6,0,5964,2234,55,59,67,77,57.0,4,72.0,10
2008-11-05 06:00:00,140.566,612.8,0,172,261,48,54,72,87,51.0,6,79.5,15
2008-11-05 12:00:00,872.98,3690.8,3232,2337,3485,46,48,87,93,47.0,2,90.0,6
2008-11-05 18:00:00,1144.466,4876.4,1857,6344,3016,48,50,87,93,49.0,2,90.0,6
2008-11-06 00:00:00,976.918,4124.4,2508,1556,1600,48,50,87,93,49.0,2,90.0,6
2008-11-06 06:00:00,145.096,615.8000000000001,0,159,500,48,48,93,93,48.0,0,93.0,0
2008-11-06 12:00:00,607.586,2578.4,0,75,4306,46,46,100,100,46.0,0,100.0,0
2008-11-06 18:00:00,257.128,1166.2,0,99,0,48,50,94,100,49.0,2,97.0,6
2008-11-07 00:00:00,578.628,2446.0,1033,97,1928,50,50,94,94,50.0,0,94.0,0
2008-11-07 06:00:00,163.358,698.2,0,97,621,48,50,93,94,49.0,2,93.5,1
2008-11-07 12:00:00,562.2719999999999,2362.6,0,66,5315,46,50,87,100,48.0,4,93.5,13
2008-11-07 18:00:00,394.338,1681.8,0,96,3258,50,54,88,94,52.0,4,91.0,6
2008-11-08 00:00:00,499.216,2104.0,1032,130,1227,43,50,87,93,46.5,7,90.0,6
2008-11-08 06:00:00,123.866,546.8,0,132,0,41,43,93,93,42.0,2,93.0,0
2008-11-08 12:00:00,498.152,2096.0,0,286,4020,39,48,87,100,43.5,9,93.5,13
2008-11-08 18:00:00,319.99,1367.2,0,286,766,50,54,77,88,52.0,4,82.5,11
2008-11-09 00:00:00,791.13,3340.8,1114,2567,1283,52,54,77,88,53.0,2,82.5,11
2008-11-09 06:00:00,192.63,822.8,141,186,116,54,54,82,94,54.0,0,88.0,12
2008-11-09 12:00:00,640.908,2737.8,2391,286,2980,50,52,87,94,51.0,2,90.5,7
2008-11-09 18:00:00,782.634,3312.0,1138,95,6247,54,54,72,82,54.0,0,77.0,10
2008-11-10 00:00:00,962.366,4101.6,2631,94,5005,52,54,82,94,53.0,2,88.0,12
2008-11-10 06:00:00,127.02,561.8,0,96,0,54,57,82,88,55.5,3,85.0,6
2008-11-10 12:00:00,721.544,3052.0,0,96,5389,55,57,82,88,56.0,2,85.0,6
2008-11-10 18:00:00,703.39,2978.2,1023,79,3935,55,59,82,88,57.0,4,85.0,6
2008-11-11 00:00:00,539.926,2266.6,0,84,961,59,59,72,82,59.0,0,77.0,10
2008-11-11 06:00:00,192.436,821.8,0,98,627,48,57,77,93,52.5,9,85.0,16
2008-11-11 12:00:00,537.114,2262.6,192,628,3695,46,50,82,87,48.0,4,84.5,5
2008-11-11 18:00:00,846.914,3561.0,1285,1466,6321,52,55,67,76,53.5,3,71.5,9
2008-11-12 00:00:00,879.486,3698.6,998,96,4008,46,52,82,93,49.0,6,87.5,11
2008-11-12 06:00:00,484.556,1983.6,0,95,72,43,45,93,100,44.0,2,96.5,7
2008-11-12 12:00:00,670.284,2793.6,0,313,5417,46,48,82,93,47.0,2,87.5,11
2008-11-12 18:00:00,508.642,2152.8,0,2210,2204,48,50,76,82,49.0,2,79.0,6
2008-11-13 00:00:00,523.0120000000001,2199.4,1066,94,1737,39,45,81,100,42.0,6,90.5,19
2008-11-13 06:00:00,120.094,526.6,0,77,0,36,41,93,100,38.5,5,96.5,7
2008-11-13 12:00:00,492.752,2038.0,0,76,4799,39,48,87,100,43.5,9,93.5,13
2008-11-13 18:00:00,119.984,532.4,0,94,0,50,54,58,82,52.0,4,70.0,24
2008-11-14 00:00:00,505.63,2126.2,0,91,1516,39,46,76,100,42.5,7,88.0,24
2008-11-14 06:00:00,125.018,559.0,0,61,0,41,43,93,93,42.0,2,93.0,0
2008-11-14 12:00:00,606.528,2531.4,1104,92,5422,43,46,87,100,44.5,3,93.5,13
2008-11-14 18:00:00,392.956,1672.4,0,92,3095,46,50,93,100,48.0,4,96.5,7
2008-11-15 00:00:00,497.236,2085.2,988,80,1412,50,50,94,94,50.0,0,94.0,0
2008-11-15 06:00:00,117.758,521.6,0,76,0,50,50,94,94,50.0,0,94.0,0
2008-11-15 12:00:00,536.51,2264.8,0,92,5027,50,52,94,100,51.0,2,97.0,6
2008-11-15 18:00:00,1030.42,4421.4,1777,3516,4399,52,52,94,94,52.0,0,94.0,0
2008-11-16 00:00:00,1346.94,5699.2,2175,115,6209,52,52,94,94,52.0,0,94.0,0
2008-11-16 06:00:00,543.396,2256.8,955,94,998,52,52,94,94,52.0,0,94.0,0
2008-11-16 12:00:00,245.714,1066.6,0,94,1185,52,54,88,94,53.0,2,91.0,6
2008-11-16 18:00:00,731.186,3060.4,1051,1063,4491,54,54,82,88,54.0,0,85.0,6
2008-11-17 00:00:00,845.136,3579.6,2785,578,2271,52,54,82,94,53.0,2,88.0,12
2008-11-17 06:00:00,169.002,713.2,0,124,559,48,52,87,94,50.0,4,90.5,7
2008-11-17 12:00:00,542.164,2252.2,0,95,5419,46,48,76,87,47.0,2,81.5,11
2008-11-17 18:00:00,345.89,1421.8,0,92,3651,46,50,58,66,48.0,4,62.0,8
2008-11-18 00:00:00,466.58,1966.2,0,67,961,41,45,71,81,43.0,4,76.0,10
2008-11-18 06:00:00,168.832,729.6,0,96,763,43,46,81,100,44.5,3,90.5,19
2008-11-18 12:00:00,719.46,3038.4,1079,97,5340,46,50,93,100,48.0,4,96.5,7
2008-11-18 18:00:00,282.658,1191.0,0,98,2548,50,52,88,100,51.0,2,94.0,12
2008-11-19 00:00:00,578.1,2445.2,0,78,2553,50,52,87,88,51.0,2,87.5,1
2008-11-19 06:00:00,122.304,532.0,0,82,0,39,50,82,93,44.5,11,87.5,11
2008-11-19 12:00:00,621.482,2598.0,1031,408,5564,39,46,93,100,42.5,7,96.5,7
2008-11-19 18:00:00,385.42,1667.8,0,2429,62,50,52,76,87,51.0,2,81.5,11
2008-11-20 00:00:00,711.032,2996.8,706,107,3078,50,50,82,87,50.0,0,84.5,5
2008-11-20 06:00:00,162.458,687.8,0,79,516,46,48,87,93,47.0,2,90.0,6
2008-11-20 12:00:00,651.9480000000001,2738.2,1034,78,5438,46,50,87,93,48.0,4,90.0,6
2008-11-20 18:00:00,224.844,978.6,0,95,617,50,54,87,94,52.0,4,90.5,7
2008-11-21 00:00:00,653.086,2773.0,0,95,1161,52,54,88,94,53.0,2,91.0,6
2008-11-21 06:00:00,170.274,731.2,0,95,759,50,50,87,94,50.0,0,90.5,7
2008-11-21 12:00:00,602.544,2549.0,1039,77,5350,48,52,87,94,50.0,4,90.5,7
2008-11-21 18:00:00,424.632,1811.4,0,81,3232,48,52,58,82,50.0,4,70.0,24
2008-11-22 00:00:00,476.48,2031.4,0,95,1055,41,48,53,87,44.5,7,70.0,34
2008-11-22 06:00:00,151.088,654.6,0,94,519,39,43,65,93,41.0,4,79.0,28
2008-11-22 12:00:00,504.938,2114.0,0,82,4648,36,43,61,75,39.5,7,68.0,14
2008-11-22 18:00:00,324.864,1389.6,0,72,1956,41,45,46,57,43.0,4,51.5,11
2008-11-23 00:00:00,730.478,3113.2,1093,634,1197,34,41,56,70,37.5,7,63.0,14
2008-11-23 06:00:00,286.624,1217.6,0,61,627,27,36,70,86,31.5,9,78.0,16
2008-11-23 12:00:00,370.992,1591.4,304,2382,879,25,36,75,93,30.5,11,84.0,18
2008-11-23 18:00:00,1157.144,4895.6,2329,2948,2591,36,43,70,100,39.5,7,85.0,30
2008-11-24 00:00:00,1590.564,6759.0,998,3432,6175,41,45,87,93,43.0,4,90.0,6
2008-11-24 06:00:00,589.53,2409.0,0,142,1037,37,41,87,93,39.0,4,90.0,6
2008-11-24 12:00:00,1010.74,4225.6,0,119,5369,36,39,87,93,37.5,3,90.0,6
2008-11-24 18:00:00,692.2760000000001,2875.8,0,153,5346,41,46,71,93,43.5,5,82.0,22
2008-11-25 00:00:00,920.452,3860.6,1063,96,1626,34,41,87,93,37.5,7,90.0,6
2008-11-25 06:00:00,464.196,1906.6,0,79,635,28,32,86,93,30.0,4,89.5,7
2008-11-25 12:00:00,906.658,3780.4,0,79,5426,32,41,81,93,36.5,9,87.0,12
2008-11-25 18:00:00,436.914,1825.4,0,94,1507,43,45,71,81,44.0,2,76.0,10
2008-11-26 00:00:00,895.082,3754.0,3010,93,2903,39,43,76,87,41.0,4,81.5,11
2008-11-26 06:00:00,99.4,402.4,0,61,0,37,39,87,93,38.0,2,90.0,6
2008-11-26 12:00:00,621.112,2565.2,0,91,6196,39,43,87,93,41.0,4,90.0,6
2008-11-26 18:00:00,206.062,849.4,0,91,1494,41,45,81,87,43.0,4,84.0,6
2008-11-27 00:00:00,589.38,2456.2,909,61,2312,34,39,93,100,36.5,5,96.5,7
2008-11-27 06:00:00,287.406,1203.2,0,91,0,0,34,93,100,17.0,34,96.5,7
2008-11-27 12:00:00,768.27,3194.4,0,61,6152,0,36,93,100,18.0,36,96.5,7
2008-11-27 18:00:00,501.098,2078.6,0,90,3678,36,39,87,93,37.5,3,90.0,6
2008-11-28 00:00:00,805.444,3375.0,2491,88,2610,34,39,81,93,36.5,5,87.0,12
2008-11-28 06:00:00,101.152,417.8,0,64,0,32,34,93,100,33.0,2,96.5,7
2008-11-28 12:00:00,683.082,2818.8,0,88,5850,32,36,87,100,34.0,4,93.5,13
2008-11-28 18:00:00,412.054,1700.4,0,66,2848,34,37,87,93,35.5,3,90.0,6
2008-11-29 00:00:00,689.676,2852.8,1113,77,2663,32,36,87,93,34.0,4,90.0,6
2008-11-29 06:00:00,132.614,543.4,0,77,537,34,36,87,93,35.0,2,90.0,6
2008-11-29 12:00:00,577.32,2409.4,0,537,3876,36,37,93,100,36.5,1,96.5,7
2008-11-29 18:00:00,693.778,2895.8,2438,1652,4652,39,43,76,93,41.0,4,84.5,17
2008-11-30 00:00:00,1030.956,4308.6,2830,126,3321,34,37,87,93,35.5,3,90.0,6
2008-11-30 06:00:00,294.966,1216.6,0,63,2019,32,34,93,100,33.0,2,96.5,7
2008-11-30 12:00:00,347.122,1434.8,0,93,568,34,39,93,100,36.5,5,96.5,7
2008-11-30 18:00:00,518.286,2136.4,0,63,2791,41,43,87,93,42.0,2,90.0,6
2008-12-01 00:00:00,1241.014,5228.2,1161,3262,6096,37,41,87,93,39.0,4,90.0,6
2008-12-01 06:00:00,129.188,562.4,0,71,0,37,39,93,100,38.0,2,96.5,7
2008-12-01 12:00:00,598.504,2506.6,0,85,5460,37,39,93,100,38.0,2,96.5,7
2008-12-01 18:00:00,335.416,1443.4,0,71,1551,41,43,87,93,42.0,2,90.0,6
2008-12-02 00:00:00,553.43,2339.8,1085,82,2002,37,43,81,93,40.0,6,87.0,12
2008-12-02 06:00:00,172.482,713.6,0,68,691,30,37,87,100,33.5,7,93.5,13
2008-12-02 12:00:00,605.614,2515.4,0,84,5459,34,39,87,93,36.5,5,90.0,6
2008-12-02 18:00:00,465.972,1962.6,0,60,3354,41,45,70,81,43.0,4,75.5,11
2008-12-03 00:00:00,549.376,2318.2,0,92,1839,41,41,81,87,41.0,0,84.0,6
2008-12-03 06:00:00,159.264,677.0,0,61,672,41,43,93,93,42.0,2,93.0,0
2008-12-03 12:00:00,688.54,2859.2,1137,92,5770,43,45,93,100,44.0,2,96.5,7
2008-12-03 18:00:00,386.732,1605.4,0,62,1325,39,46,81,100,42.5,7,90.5,19
2008-12-04 00:00:00,520.628,2158.6,0,87,1897,30,37,87,100,33.5,7,93.5,13
2008-12-04 06:00:00,159.932,678.2,0,65,666,28,32,93,100,30.0,4,96.5,7
2008-12-04 12:00:00,654.938,2700.4,1085,61,5535,32,41,93,100,36.5,9,96.5,7
2008-12-04 18:00:00,297.326,1223.8,0,93,2894,43,50,87,100,46.5,7,93.5,13
2008-12-05 00:00:00,626.442,2631.8,0,62,2219,43,45,87,93,44.0,2,90.0,6
2008-12-05 06:00:00,237.44,1027.2,0,74,673,43,45,87,93,44.0,2,90.0,6
2008-12-05 12:00:00,621.858,2576.8,0,81,5716,43,45,81,87,44.0,2,84.0,6
2008-12-05 18:00:00,417.772,1745.0,0,62,1832,45,46,87,93,45.5,1,90.0,6
2008-12-06 00:00:00,781.548,3244.4,831,93,1631,41,45,87,87,43.0,4,87.0,0
2008-12-06 06:00:00,179.944,736.0,0,61,1024,43,43,87,93,43.0,0,90.0,6
2008-12-06 12:00:00,917.562,3868.6,2380,3176,5066,43,45,87,93,44.0,2,90.0,6
2008-12-06 18:00:00,828.198,3497.6,1625,2413,2426,45,46,76,81,45.5,1,78.5,5
2008-12-07 00:00:00,598.132,2493.8,0,99,532,41,45,81,93,43.0,4,87.0,12
2008-12-07 06:00:00,216.75,901.8,0,65,1066,36,41,93,93,38.5,5,93.0,0
2008-12-07 12:00:00,510.466,2110.8,366,96,3606,34,37,93,100,35.5,3,96.5,7
2008-12-07 18:00:00,785.034,3304.8,2928,64,2652,37,37,93,100,37.0,0,96.5,7
2008-12-08 00:00:00,954.49,3989.2,0,85,6303,36,37,93,93,36.5,1,93.0,0
2008-12-08 06:00:00,249.61,1081.6,0,74,1487,34,36,93,100,35.0,2,96.5,7
2008-12-08 12:00:00,746.028,3084.0,1117,63,5941,34,34,93,100,34.0,0,96.5,7
2008-12-08 18:00:00,391.638,1590.2,0,63,4709,34,36,87,100,35.0,2,93.5,13
2008-12-09 00:00:00,481.36,1996.0,0,96,1119,34,36,87,93,35.0,2,90.0,6
2008-12-09 06:00:00,168.786,690.8,0,64,779,34,36,87,93,35.0,2,90.0,6
2008-12-09 12:00:00,647.62,2685.2,1147,63,5463,0,34,87,93,17.0,34,90.0,6
2008-12-09 18:00:00,464.696,1881.0,0,145,5135,0,37,87,100,18.5,37,93.5,13
2008-12-10 00:00:00,722.042,3034.0,838,2281,1509,34,37,93,93,35.5,3,93.0,0
2008-12-10 06:00:00,141.77,583.0,0,103,659,28,36,87,100,32.0,8,93.5,13
2008-12-10 12:00:00,647.794,2688.4,1128,64,4257,34,37,87,93,35.5,3,90.0,6
2008-12-10 18:00:00,831.642,3417.8,0,3381,4787,39,39,81,87,39.0,0,84.0,6
2008-12-11 00:00:00,489.814,2037.0,0,596,1186,32,39,81,87,35.5,7,84.0,6
2008-12-11 06:00:00,145.666,611.0,0,80,732,27,30,93,93,28.5,3,93.0,0
2008-12-11 12:00:00,650.1320000000001,2674.8,1160,64,5894,0,28,93,100,14.0,28,96.5,7
2008-12-11 18:00:00,166.718,699.8,0,65,135,36,41,75,87,38.5,5,81.0,12
2008-12-12 00:00:00,470.006,1950.0,0,64,1218,0,36,81,100,18.0,36,90.5,19
2008-12-12 06:00:00,158.24,657.8,0,64,782,28,30,93,100,29.0,2,96.5,7
2008-12-12 12:00:00,556.204,2290.0,0,63,5699,28,30,93,100,29.0,2,96.5,7
2008-12-12 18:00:00,447.386,1859.2,0,64,3556,30,32,87,93,31.0,2,90.0,6
2008-12-13 00:00:00,653.7040000000001,2712.2,1157,64,2117,28,30,93,100,29.0,2,96.5,7
2008-12-13 06:00:00,133.67,544.2,0,64,570,27,30,93,100,28.5,3,96.5,7
2008-12-13 12:00:00,534.91,2242.4,0,65,4556,28,32,75,86,30.0,4,80.5,11
2008-12-13 18:00:00,772.8240000000001,3253.0,2186,65,3160,34,34,70,93,34.0,0,81.5,23
2008-12-14 00:00:00,384.17,1623.8000000000002,0,67,985,36,37,93,100,36.5,1,96.5,7
2008-12-14 06:00:00,153.49,665.2,0,66,508,37,39,93,100,38.0,2,96.5,7
2008-12-14 12:00:00,600.8140000000001,2554.0,1357,667,1937,39,39,93,100,39.0,0,96.5,7
2008-12-14 18:00:00,704.732,2970.8,2385,1679,2238,39,41,87,100,40.0,2,93.5,13
2008-12-15 00:00:00,543.0840000000001,2279.4,0,85,732,37,39,81,87,38.0,2,84.0,6
2008-12-15 06:00:00,153.38,653.0,0,64,542,36,37,87,93,36.5,1,90.0,6
2008-12-15 12:00:00,572.684,2376.8,0,62,5064,34,36,87,93,35.0,2,90.0,6
2008-12-15 18:00:00,349.516,1448.6,0,63,3186,34,37,87,93,35.5,3,90.0,6
2008-12-16 00:00:00,719.87,2996.6,1178,63,876,34,34,93,100,34.0,0,96.5,7
2008-12-16 06:00:00,171.79999999999998,726.4,0,64,795,34,34,93,100,34.0,0,96.5,7
2008-12-16 12:00:00,678.326,2800.6,0,62,5518,0,34,93,100,17.0,34,96.5,7
2008-12-16 18:00:00,439.586,1841.6,0,64,3999,34,34,93,100,34.0,0,96.5,7
2008-12-17 00:00:00,507.378,2108.8,0,63,1022,0,34,93,100,17.0,34,96.5,7
2008-12-17 06:00:00,162.016,696.2,0,63,689,30,30,93,100,30.0,0,96.5,7
2008-12-17 12:00:00,632.64,2621.6,1195,74,5516,30,36,93,100,33.0,6,96.5,7
2008-12-17 18:00:00,387.578,1598.8000000000002,0,84,2067,36,43,93,100,39.5,7,96.5,7
2008-12-18 00:00:00,916.552,3839.0,3056,63,2541,37,43,87,93,40.0,6,90.0,6
2008-12-18 06:00:00,146.122,603.2,0,63,561,32,36,93,100,34.0,4,96.5,7
2008-12-18 12:00:00,662.228,2736.0,0,62,5960,36,39,93,100,37.5,3,96.5,7
2008-12-18 18:00:00,336.986,1384.6,0,63,3891,41,45,93,100,43.0,4,96.5,7
2008-12-19 00:00:00,591.604,2460.8,1125,70,881,45,46,93,100,45.5,1,96.5,7
2008-12-19 06:00:00,167.284,725.2,0,88,727,46,46,93,93,46.0,0,93.0,0
2008-12-19 12:00:00,554.444,2308.2,0,63,5464,46,48,82,93,47.0,2,87.5,11
2008-12-19 18:00:00,424.01,1784.8,0,64,3292,43,48,71,81,45.5,5,76.0,10
2008-12-20 00:00:00,736.3739999999999,3073.2000000000003,1538,81,2290,39,43,87,87,41.0,4,87.0,0
2008-12-20 06:00:00,107.63,468.8,0,76,60,41,43,87,93,42.0,2,90.0,6
2008-12-20 12:00:00,712.112,2949.2,0,573,5725,41,46,87,93,43.5,5,90.0,6
2008-12-20 18:00:00,837.466,3522.0,1132,5611,2242,48,50,87,94,49.0,2,90.5,7
2008-12-21 00:00:00,585.294,2413.2,0,219,4792,50,50,82,87,50.0,0,84.5,5
2008-12-21 06:00:00,272.80600000000004,1135.4,0,1197,1461,50,50,87,87,50.0,0,87.0,0
2008-12-21 12:00:00,747.4780000000001,3136.8,0,2213,3545,48,50,87,93,49.0,2,90.0,6
2008-12-21 18:00:00,816.2439999999999,3384.4,0,3781,6436,48,50,82,87,49.0,2,84.5,5
2008-12-22 00:00:00,807.082,3377.6,1099,1998,3374,48,48,82,87,48.0,0,84.5,5
2008-12-22 06:00:00,162.692,682.6,0,134,799,46,48,82,87,47.0,2,84.5,5
2008-12-22 12:00:00,536.174,2229.0,0,97,4643,46,48,82,87,47.0,2,84.5,5
2008-12-22 18:00:00,671.836,2825.2,1663,64,3792,48,50,82,93,49.0,2,87.5,11
2008-12-23 00:00:00,645.106,2697.4,494,96,1199,48,48,93,93,48.0,0,93.0,0
2008-12-23 06:00:00,311.188,1282.2,557,65,550,48,48,93,100,48.0,0,96.5,7
2008-12-23 12:00:00,512.194,2140.2,0,95,4050,46,48,93,100,47.0,2,96.5,7
2008-12-23 18:00:00,493.354,2108.0,1068,64,3079,46,50,76,87,48.0,4,81.5,11
2008-12-24 00:00:00,481.352,2030.6,1041,1891,647,39,45,87,93,42.0,6,90.0,6
2008-12-24 06:00:00,136.068,562.2,0,114,501,32,39,93,100,35.5,7,96.5,7
2008-12-24 12:00:00,427.904,1761.4,0,87,4294,34,37,93,100,35.5,3,96.5,7
2008-12-24 18:00:00,484.124,1994.4,0,65,4202,39,43,87,93,41.0,4,90.0,6
2008-12-25 00:00:00,221.542,914.4,0,98,984,43,45,76,87,44.0,2,81.5,11
2008-12-25 06:00:00,228.038,933.6,0,64,709,41,43,76,87,42.0,2,81.5,11
2008-12-25 12:00:00,370.524,1539.4,0,82,2331,39,43,81,87,41.0,4,84.0,6
2008-12-25 18:00:00,156.68599999999998,652.8,0,76,139,43,45,71,76,44.0,2,73.5,5
2008-12-26 00:00:00,305.87,1249.8,0,63,419,41,43,70,81,42.0,2,75.5,11
2008-12-26 06:00:00,141.488,575.8,0,75,684,32,39,75,87,35.5,7,81.0,12
2008-12-26 12:00:00,317.986,1309.0,0,81,3117,32,34,60,75,33.0,2,67.5,15
2008-12-26 18:00:00,489.966,2024.8,1113,62,3569,34,39,49,60,36.5,5,54.5,11
2008-12-27 00:00:00,274.29200000000003,1131.4,8,61,426,32,34,60,69,33.0,2,64.5,9
2008-12-27 06:00:00,878.6980000000001,3568.2,0,61,5988,28,32,64,74,30.0,4,69.0,10
2008-12-27 12:00:00,591.7719999999999,2408.0,0,61,1410,28,32,69,80,30.0,4,74.5,11
2008-12-27 18:00:00,569.444,2326.0,0,61,847,32,36,65,75,34.0,4,70.0,10
2008-12-28 00:00:00,932.25,3839.6,0,61,3964,30,32,75,80,31.0,2,77.5,5
2008-12-28 06:00:00,701.496,2825.6000000000004,1223,62,545,25,28,74,86,26.5,3,80.0,12
2008-12-28 12:00:00,362.48,1470.6,730,60,188,25,28,80,86,26.5,3,83.0,6
2008-12-28 18:00:00,381.216,1549.0,0,33,4332,30,34,60,75,32.0,4,67.5,15
2008-12-29 00:00:00,125.45,519.6,0,62,226,28,30,74,80,29.0,2,77.0,6
2008-12-29 06:00:00,133.626,549.8,0,62,592,25,28,74,86,26.5,3,80.0,12
2008-12-29 12:00:00,152.034,620.2,0,32,928,25,27,80,86,26.0,2,83.0,6
2008-12-29 18:00:00,97.742,402.0,0,62,0,30,36,65,75,33.0,6,70.0,10
2008-12-30 00:00:00,171.876,701.6,0,62,960,28,32,75,86,30.0,4,80.5,11
2008-12-30 06:00:00,159.75,646.8,0,61,984,28,30,80,86,29.0,2,83.0,6
2008-12-30 12:00:00,119.74,499.0,0,61,0,30,34,75,86,32.0,4,80.5,11
2008-12-30 18:00:00,542.614,2227.6,0,61,2566,32,32,87,93,32.0,0,90.0,6
2008-12-31 00:00:00,373.134,1525.2,0,62,3595,32,34,87,93,33.0,2,90.0,6
2008-12-31 06:00:00,140.17,570.4,0,61,714,32,34,87,93,33.0,2,90.0,6
2008-12-31 12:00:00,411.232,1718.0,0,62,1967,32,34,87,93,33.0,2,90.0,6
2008-12-31 18:00:00,649.322,2693.2,1172,61,5846,34,37,81,93,35.5,3,87.0,12
2009-01-01 00:00:00,763.4639999999999,3208.6,1803,62,3333,34,36,87,93,35.0,2,90.0,6
2009-01-01 06:00:00,195.87,876.2,0,61,0,32,34,93,93,33.0,2,93.0,0
2009-01-01 12:00:00,285.906,1248.2,765,61,978,34,36,87,100,35.0,2,93.5,13
2009-01-01 18:00:00,160.926,678.4,0,61,957,32,36,93,100,34.0,4,96.5,7
2009-01-02 00:00:00,763.99,3173.0,0,3662,868,28,32,93,100,30.0,4,96.5,7
2009-01-02 06:00:00,290.836,1207.2,0,1887,796,27,28,93,100,27.5,1,96.5,7
2009-01-02 12:00:00,562.7860000000001,2359.2,0,3597,2617,27,30,93,100,28.5,3,96.5,7
2009-01-02 18:00:00,744.5219999999999,3085.6,1235,168,5906,34,36,75,87,35.0,2,81.0,12
2009-01-03 00:00:00,729.366,3050.4,1182,366,2522,30,34,75,93,32.0,4,84.0,18
2009-01-03 06:00:00,108.592,449.6,0,72,35,28,32,86,93,30.0,4,89.5,7
2009-01-03 12:00:00,667.484,2783.4,2470,66,4430,27,32,80,93,29.5,5,86.5,13
2009-01-03 18:00:00,454.304,1906.4,1769,77,2643,32,36,65,75,34.0,4,70.0,10
2009-01-04 00:00:00,683.116,2825.0,2201,113,3331,25,30,80,93,27.5,5,86.5,13
2009-01-04 06:00:00,198.362,821.6,0,65,506,21,25,86,93,23.0,4,89.5,7
2009-01-04 12:00:00,214.734,911.6,0,397,0,19,27,86,100,23.0,8,93.0,14
2009-01-04 18:00:00,715.94,2979.4,1457,2602,1396,28,32,64,80,30.0,4,72.0,16
2009-01-05 00:00:00,810.9580000000001,3399.2,0,2187,1343,25,28,80,86,26.5,3,83.0,6
2009-01-05 06:00:00,164.296,690.0,0,77,597,28,28,74,80,28.0,0,77.0,6
2009-01-05 12:00:00,592.684,2445.8,0,116,5714,28,30,74,93,29.0,2,83.5,19
2009-01-05 18:00:00,170.174,715.4,0,65,569,30,32,93,100,31.0,2,96.5,7
2009-01-06 00:00:00,676.846,2825.0,1247,64,1770,28,30,93,100,29.0,2,96.5,7
2009-01-06 06:00:00,160.384,673.6,0,63,662,28,30,86,93,29.0,2,89.5,7
2009-01-06 12:00:00,643.124,2659.4,0,64,5800,19,27,86,93,23.0,8,89.5,7
2009-01-06 18:00:00,409.97,1671.6,0,64,4180,21,25,80,93,23.0,4,86.5,13
2009-01-07 00:00:00,476.384,1956.4,0,63,1820,16,19,73,86,17.5,3,79.5,13
2009-01-07 06:00:00,127.028,527.2,0,64,0,14,14,79,86,14.0,0,82.5,7
2009-01-07 12:00:00,585.174,2403.0,0,428,5872,10,23,63,85,16.5,13,74.0,22
2009-01-07 18:00:00,664.72,2734.6,1356,3223,2874,27,30,43,64,28.5,3,53.5,21
2009-01-08 00:00:00,703.35,2898.6,1331,105,1233,30,32,69,93,31.0,2,81.0,24
2009-01-08 06:00:00,164.76,691.4,0,64,761,30,32,93,100,31.0,2,96.5,7
2009-01-08 12:00:00,567.06,2338.2,1165,64,5323,27,30,80,100,28.5,3,90.0,20
2009-01-08 18:00:00,264.388,1101.8,0,64,2437,30,34,65,75,32.0,4,70.0,10
2009-01-09 00:00:00,637.062,2666.4,1608,107,1554,25,28,74,80,26.5,3,77.0,6
2009-01-09 06:00:00,164.696,690.8000000000001,0,82,730,18,25,69,86,21.5,7,77.5,17
2009-01-09 12:00:00,628.358,2581.8,0,63,5942,18,23,74,86,20.5,5,80.0,12
2009-01-09 18:00:00,293.178,1287.6,0,65,694,25,30,64,74,27.5,5,69.0,10
2009-01-10 00:00:00,702.47,2902.0,1802,62,1919,21,27,74,86,24.0,6,80.0,12
2009-01-10 06:00:00,97.816,398.6,0,63,0,16,21,86,93,18.5,5,89.5,7
2009-01-10 12:00:00,541.842,2233.2,0,61,5468,14,23,86,100,18.5,9,93.0,14
2009-01-10 18:00:00,562.2139999999999,2357.8,1321,65,3098,27,34,60,80,30.5,7,70.0,20
2009-01-11 00:00:00,901.076,3778.4,1507,4099,3973,21,27,80,93,24.0,6,86.5,13
2009-01-11 06:00:00,119.028,546.4,0,208,0,16,19,86,93,17.5,3,89.5,7
2009-01-11 12:00:00,303.37800000000004,1281.4,0,1228,1334,16,23,86,100,19.5,7,93.0,14
2009-01-11 18:00:00,586.516,2449.2,1181,3741,1059,28,37,60,80,32.5,9,70.0,20
2009-01-12 00:00:00,967.066,4024.2,3340,124,3494,28,36,70,86,32.0,8,78.0,16
2009-01-12 06:00:00,134.722,549.0,0,66,527,27,28,86,86,27.5,1,86.0,0
2009-01-12 12:00:00,511.806,2098.6,0,65,5286,27,34,75,93,30.5,7,84.0,18
2009-01-12 18:00:00,452.222,1826.0,0,66,5242,36,39,75,81,37.5,3,78.0,6
2009-01-13 00:00:00,490.528,2026.4,0,64,1092,39,41,76,81,40.0,2,78.5,5
2009-01-13 06:00:00,159.824,688.2,0,65,724,39,41,75,76,40.0,2,75.5,1
2009-01-13 12:00:00,737.85,3056.4,1140,130,5866,37,39,81,87,38.0,2,84.0,6
2009-01-13 18:00:00,490.234,2000.6,0,67,5400,39,43,66,87,41.0,4,76.5,21
2009-01-14 00:00:00,794.692,3261.0,0,67,4204,39,39,87,93,39.0,0,90.0,6
2009-01-14 06:00:00,117.062,484.2000000000001,0,69,154,37,39,93,100,38.0,2,96.5,7
2009-01-14 12:00:00,690.542,2838.0,1198,130,5709,37,39,93,100,38.0,2,96.5,7
2009-01-14 18:00:00,293.518,1198.2,0,68,2023,39,39,87,100,39.0,0,93.5,13
2009-01-15 00:00:00,675.16,2818.8,1079,65,2415,37,39,87,93,38.0,2,90.0,6
2009-01-15 06:00:00,138.206,571.6,0,130,578,32,37,87,93,34.5,5,90.0,6
2009-01-15 12:00:00,505.438,2092.0,0,64,5134,30,37,81,93,33.5,7,87.0,12
2009-01-15 18:00:00,218.956,897.8,0,66,1866,39,43,66,81,41.0,4,73.5,15
2009-01-16 00:00:00,701.468,2948.2,2731,130,1983,36,37,81,87,36.5,1,84.0,6
2009-01-16 06:00:00,160.042,680.6,0,64,654,32,36,87,93,34.0,4,90.0,6
2009-01-16 12:00:00,560.342,2312.2,0,60,5550,30,37,81,100,33.5,7,90.5,19
2009-01-16 18:00:00,633.346,2651.6000000000004,1140,769,3656,37,41,81,87,39.0,4,84.0,6
2009-01-17 00:00:00,1412.824,5934.0,4671,2265,5360,41,43,81,93,42.0,2,87.0,12
2009-01-17 06:00:00,585.098,2388.2,595,170,577,41,41,93,100,41.0,0,96.5,7
2009-01-17 12:00:00,912.514,3789.2,0,578,4081,41,45,93,100,43.0,4,96.5,7
2009-01-17 18:00:00,787.53,3292.2,1173,2253,4344,45,46,93,93,45.5,1,93.0,0
2009-01-18 00:00:00,1032.678,4324.0,709,153,6320,46,46,87,93,46.0,0,90.0,6
2009-01-18 06:00:00,157.664,661.1999999999999,0,140,812,45,46,81,93,45.5,1,87.0,12
2009-01-18 12:00:00,681.342,2873.2,1625,2401,994,45,46,87,93,45.5,1,90.0,6
2009-01-18 18:00:00,1062.948,4405.8,1456,1825,5481,41,46,66,87,43.5,5,76.5,21
2009-01-19 00:00:00,1252.24,5261.2,2568,2335,5440,39,43,76,87,41.0,4,81.5,11
2009-01-19 06:00:00,145.656,616.4,0,149,526,41,43,87,93,42.0,2,90.0,6
2009-01-19 12:00:00,624.778,2589.8,0,65,5674,43,52,71,100,47.5,9,85.5,29
2009-01-19 18:00:00,280.81,1158.8,0,66,2860,46,54,62,87,50.0,8,74.5,25
2009-01-20 00:00:00,648.622,2726.2,1118,96,1219,41,45,76,81,43.0,4,78.5,5
2009-01-20 06:00:00,146.404,609.8,0,63,749,36,39,75,87,37.5,3,81.0,12
2009-01-20 12:00:00,629.194,2614.6,0,63,5786,34,37,87,93,35.5,3,90.0,6
2009-01-20 18:00:00,527.22,2151.8,0,90,6407,41,43,76,87,42.0,2,81.5,11
2009-01-21 00:00:00,435.21,1794.6,0,66,785,34,41,87,100,37.5,7,93.5,13
2009-01-21 06:00:00,102.516,424.2,0,62,0,34,36,93,100,35.0,2,96.5,7
2009-01-21 12:00:00,695.75,2859.0,0,528,6193,34,36,100,100,35.0,2,100.0,0
2009-01-21 18:00:00,378.152,1551.0,590,96,2590,36,37,93,100,36.5,1,96.5,7
2009-01-22 00:00:00,563.016,2355.6,558,1473,1047,36,37,87,93,36.5,1,90.0,6
2009-01-22 06:00:00,169.774,718.2,0,135,785,36,37,87,93,36.5,1,90.0,6
2009-01-22 12:00:00,559.828,2325.4,0,78,5279,37,41,93,100,39.0,4,96.5,7
2009-01-22 18:00:00,209.744,887.2,0,64,1120,41,45,93,100,43.0,4,96.5,7
2009-01-23 00:00:00,298.01,1238.8,0,64,1062,45,46,93,100,45.5,1,96.5,7
2009-01-23 06:00:00,120.704,514.2,0,99,0,46,48,93,100,47.0,2,96.5,7
2009-01-23 12:00:00,669.382,2799.4,1183,66,5666,52,54,82,100,53.0,2,91.0,18
2009-01-23 18:00:00,576.822,2395.6,895,66,4535,45,48,71,82,46.5,3,76.5,11
2009-01-24 00:00:00,543.628,2255.2,0,64,1945,37,43,70,87,40.0,6,78.5,17
2009-01-24 06:00:00,121.682,527.4,0,97,0,36,37,87,93,36.5,1,90.0,6
2009-01-24 12:00:00,792.7539999999999,3315.4,1586,2910,4836,37,39,87,93,38.0,2,90.0,6
2009-01-24 18:00:00,544.7620000000001,2294.0,3016,1392,1692,41,45,66,81,43.0,4,73.5,15
2009-01-25 00:00:00,741.572,3066.4,494,93,1794,34,43,70,93,38.5,9,81.5,23
2009-01-25 06:00:00,632.768,2556.6,1130,62,880,34,34,93,100,34.0,0,96.5,7
2009-01-25 12:00:00,582.128,2386.0,0,62,1118,34,41,81,100,37.5,7,90.5,19
2009-01-25 18:00:00,1087.314,4531.8,2841,5108,6450,43,45,66,76,44.0,2,71.0,10
2009-01-26 00:00:00,541.454,2263.6,0,728,2765,41,43,70,93,42.0,2,81.5,23
2009-01-26 06:00:00,107.468,450.0,0,123,0,41,41,93,100,41.0,0,96.5,7
2009-01-26 12:00:00,464.856,1951.8,0,64,3780,37,39,93,100,38.0,2,96.5,7
2009-01-26 18:00:00,558.992,2294.8,0,65,4541,39,41,87,100,40.0,2,93.5,13
2009-01-27 00:00:00,543.156,2265.0,1121,96,1500,39,39,93,93,39.0,0,93.0,0
2009-01-27 06:00:00,177.824,764.8,0,64,653,37,39,87,93,38.0,2,90.0,6
2009-01-27 12:00:00,549.626,2316.8,0,62,4708,37,37,93,93,37.0,0,93.0,0
2009-01-27 18:00:00,228.96,972.0,0,64,604,39,43,81,93,41.0,4,87.0,12
2009-01-28 00:00:00,468.62,1948.2,896,88,643,34,37,87,100,35.5,3,93.5,13
2009-01-28 06:00:00,326.548,1345.6,1094,498,1359,34,36,93,100,35.0,2,96.5,7
2009-01-28 12:00:00,601.72,2481.8,0,62,5264,36,36,93,100,36.0,0,96.5,7
2009-01-28 18:00:00,1097.118,4518.6,0,4787,5951,37,39,70,87,38.0,2,78.5,17
2009-01-29 00:00:00,696.348,2930.6,1207,1602,1711,30,37,75,100,33.5,7,87.5,25
2009-01-29 06:00:00,143.254,599.2,0,101,644,28,28,100,100,28.0,0,100.0,0
2009-01-29 12:00:00,533.6800000000001,2212.2,0,65,4097,28,28,100,100,28.0,0,100.0,0
2009-01-29 18:00:00,476.056,1976.2,0,63,3219,0,39,70,93,19.5,39,81.5,23
2009-01-30 00:00:00,420.708,1739.4,0,65,1036,0,36,81,93,18.0,36,87.0,12
2009-01-30 06:00:00,107.708,450.2,0,62,0,27,30,93,100,28.5,3,96.5,7
2009-01-30 12:00:00,639.172,2656.2000000000003,1156,61,5272,28,34,81,100,31.0,6,90.5,19
2009-01-30 18:00:00,747.082,3071.0,0,62,6097,36,39,70,81,37.5,3,75.5,11
2009-01-31 00:00:00,565.076,2344.4,466,95,778,36,37,75,81,36.5,1,78.0,6
2009-01-31 06:00:00,133.452,558.2,0,61,521,32,36,75,87,34.0,4,81.0,12
2009-01-31 12:00:00,779.624,3236.0,0,2110,5206,30,36,75,86,33.0,6,80.5,11
2009-01-31 18:00:00,1045.924,4398.8,4409,3805,3970,37,39,65,70,38.0,2,67.5,5
2009-02-01 00:00:00,1353.852,5678.8,3869,599,5612,30,36,75,80,33.0,6,77.5,5
2009-02-01 06:00:00,543.984,2261.6,805,423,3559,27,28,74,80,27.5,1,77.0,6
2009-02-01 12:00:00,291.95000000000005,1242.4,916,67,715,25,32,69,86,28.5,7,77.5,17
2009-02-01 18:00:00,478.302,2012.2,1609,66,1984,34,36,56,65,35.0,2,60.5,9
2009-02-02 00:00:00,493.2240000000001,2048.6,0,66,1236,32,34,56,69,33.0,2,62.5,13
2009-02-02 06:00:00,137.646,565.0,0,66,589,28,32,69,100,30.0,4,84.5,31
2009-02-02 12:00:00,560.06,2299.8,0,66,6091,28,34,93,100,31.0,6,96.5,7
2009-02-02 18:00:00,178.792,734.2,0,34,1066,36,41,93,100,38.5,5,96.5,7
2009-02-03 00:00:00,726.802,2997.8,1159,66,3169,32,41,93,100,36.5,9,96.5,7
2009-02-03 06:00:00,107.602,462.0,0,67,0,28,32,93,93,30.0,4,93.0,0
2009-02-03 12:00:00,600.498,2486.0,0,65,6114,25,30,93,100,27.5,5,96.5,7
2009-02-03 18:00:00,593.6320000000001,2416.4,703,66,6624,32,37,60,87,34.5,5,73.5,27
2009-02-04 00:00:00,566.658,2330.8,0,680,2246,25,32,69,93,28.5,7,81.0,24
2009-02-04 06:00:00,137.66,561.6,0,49,658,23,25,93,100,24.0,2,96.5,7
2009-02-04 12:00:00,1016.556,4215.2,0,4626,6105,19,30,93,100,24.5,11,96.5,7
2009-02-04 18:00:00,660.716,2695.2,871,2219,5114,32,36,87,93,34.0,4,90.0,6
2009-02-05 00:00:00,645.992,2667.6,0,67,4083,34,37,87,100,35.5,3,93.5,13
2009-02-05 06:00:00,206.032,851.8,0,66,1667,37,41,87,100,39.0,4,93.5,13
2009-02-05 12:00:00,521.72,2159.2,0,65,5763,41,45,87,93,43.0,4,90.0,6
2009-02-05 18:00:00,423.78,1777.8,1104,67,2943,46,50,71,87,48.0,4,79.0,16
2009-02-06 00:00:00,497.556,2069.2,0,66,2614,41,46,81,93,43.5,5,87.0,12
2009-02-06 06:00:00,205.576,849.1999999999999,0,67,1306,36,41,87,100,38.5,5,93.5,13
2009-02-06 12:00:00,741.466,3078.0,1165,66,6067,39,45,76,87,42.0,6,81.5,11
2009-02-06 18:00:00,400.178,1682.6,0,68,2917,48,52,62,71,50.0,4,66.5,9
2009-02-07 00:00:00,701.1759999999999,2917.4,0,72,1426,39,46,76,100,42.5,7,88.0,24
2009-02-07 06:00:00,154.482,640.8,0,67,396,32,39,93,100,35.5,7,96.5,7
2009-02-07 12:00:00,667.608,2790.8,2664,67,4729,32,37,93,100,34.5,5,96.5,7
2009-02-07 18:00:00,1126.36,4717.2,1675,4284,6370,34,36,81,100,35.0,2,90.5,19
2009-02-08 00:00:00,1183.086,4927.8,2483,65,6378,34,36,75,87,35.0,2,81.0,12
2009-02-08 06:00:00,573.11,2348.8,862,65,4929,28,30,93,100,29.0,2,96.5,7
2009-02-08 12:00:00,305.202,1297.4,0,64,2689,28,36,87,100,32.0,8,93.5,13
2009-02-08 18:00:00,554.914,2315.4,1676,65,4576,37,45,61,87,41.0,8,74.0,26
2009-02-09 00:00:00,749.64,3153.0,2803,65,2980,34,36,87,100,35.0,2,93.5,13
2009-02-09 06:00:00,141.808,597.0,0,32,549,34,37,93,100,35.5,3,96.5,7
2009-02-09 12:00:00,629.848,2608.2,12,65,5671,37,39,93,100,38.0,2,96.5,7
2009-02-09 18:00:00,468.578,1995.2,1051,65,2181,41,46,93,100,43.5,5,96.5,7
2009-02-10 00:00:00,466.404,1950.0,0,66,974,48,52,88,100,50.0,4,94.0,12
2009-02-10 06:00:00,150.088,618.0,0,67,719,46,52,71,93,49.0,6,82.0,22
2009-02-10 12:00:00,590.982,2473.0,0,66,5218,41,45,81,87,43.0,4,84.0,6
2009-02-10 18:00:00,611.176,2493.4,0,66,5935,41,41,87,87,41.0,0,87.0,0
2009-02-11 00:00:00,591.576,2456.8,1128,64,467,36,39,81,93,37.5,3,87.0,12
2009-02-11 06:00:00,140.78,598.2,0,63,424,30,37,87,100,33.5,7,93.5,13
2009-02-11 12:00:00,670.658,2804.2,0,884,5685,28,39,93,100,33.5,11,96.5,7
2009-02-11 18:00:00,802.096,3385.4,321,5477,3713,43,45,66,81,44.0,2,73.5,15
2009-02-12 00:00:00,1025.856,4345.2,2664,4053,2373,37,41,70,87,39.0,4,78.5,17
2009-02-12 06:00:00,150.568,631.8,0,109,694,36,39,81,87,37.5,3,84.0,6
2009-02-12 12:00:00,586.908,2446.0,0,64,5710,36,37,81,87,36.5,1,84.0,6
2009-02-12 18:00:00,530.282,2179.0,0,63,6488,37,41,61,81,39.0,4,71.0,20
2009-02-13 00:00:00,700.902,2926.2,1109,63,4832,34,41,65,81,37.5,7,73.0,16
2009-02-13 06:00:00,99.762,428.2000000000001,0,64,0,32,34,87,100,33.0,2,93.5,13
2009-02-13 12:00:00,587.864,2458.0,1100,63,5131,32,34,93,100,33.0,2,96.5,7
2009-02-13 18:00:00,472.378,1940.2,0,64,4518,34,37,93,100,35.5,3,96.5,7
2009-02-14 00:00:00,530.018,2217.8,0,63,1905,36,37,87,93,36.5,1,90.0,6
2009-02-14 06:00:00,118.596,496.2000000000001,0,63,232,30,36,87,100,33.0,6,93.5,13
2009-02-14 12:00:00,714.7479999999999,2996.6,1871,62,5493,34,36,75,93,35.0,2,84.0,18
2009-02-14 18:00:00,742.48,3054.8,103,3068,6522,36,39,61,75,37.5,3,68.0,14
2009-02-15 00:00:00,756.77,3129.4,306,63,6262,30,37,60,80,33.5,7,70.0,20
2009-02-15 06:00:00,489.818,1968.4,0,64,0,25,30,80,100,27.5,5,90.0,20
2009-02-15 12:00:00,608.52,2506.4,1375,32,2143,27,36,81,100,31.5,9,90.5,19
2009-02-15 18:00:00,247.302,1009.4,10,65,2402,39,43,46,61,41.0,4,53.5,15
2009-02-16 00:00:00,240.392,997.8,1080,65,689,34,37,60,75,35.5,3,67.5,15
2009-02-16 06:00:00,136.946,546.2,0,66,41,37,37,70,87,37.0,0,78.5,17
2009-02-16 12:00:00,242.714,1023.0,0,65,782,37,43,87,93,40.0,6,90.0,6
2009-02-16 18:00:00,253.556,1079.0,0,65,919,45,48,71,87,46.5,3,79.0,16
2009-02-17 00:00:00,685.778,2864.4,0,65,5295,41,46,76,93,43.5,5,84.5,17
2009-02-17 06:00:00,95.838,394.6,0,65,0,41,43,87,100,42.0,2,93.5,13
2009-02-17 12:00:00,332.73,1402.6,0,67,2158,43,46,81,93,44.5,3,87.0,12
2009-02-17 18:00:00,185.13,765.6,0,67,1195,48,50,71,82,49.0,2,76.5,11
2009-02-18 00:00:00,168.0,692.4,0,67,572,46,48,82,93,47.0,2,87.5,11
2009-02-18 06:00:00,175.228,711.2,0,66,719,43,46,87,100,44.5,3,93.5,13
2009-02-18 12:00:00,221.352,910.6,0,81,1583,41,43,93,100,42.0,2,96.5,7
2009-02-18 18:00:00,245.69,1015.2,0,84,2451,39,41,81,93,40.0,2,87.0,12
2009-02-19 00:00:00,184.18,755.4,0,66,718,36,39,70,87,37.5,3,78.5,17
2009-02-19 06:00:00,131.178,526.2,0,65,0,27,34,75,93,30.5,7,84.0,18
2009-02-19 12:00:00,187.35,773.1999999999999,0,66,863,25,39,56,100,32.0,14,78.0,44
2009-02-19 18:00:00,285.744,1202.0,1046,66,933,41,46,37,46,43.5,5,41.5,9
2009-02-20 00:00:00,132.996,539.2,0,65,0,41,43,57,65,42.0,2,61.0,8
2009-02-20 06:00:00,192.902,776.8,0,66,999,41,41,70,87,41.0,0,78.5,17
2009-02-20 12:00:00,292.854,1259.2,0,65,1911,41,45,81,87,43.0,4,84.0,6
2009-02-20 18:00:00,498.38,2135.4,2031,83,732,46,50,66,81,48.0,4,73.5,15
2009-02-21 00:00:00,896.6,3799.0,866,79,5126,43,48,71,87,45.5,5,79.0,16
2009-02-21 06:00:00,557.598,2310.8,1044,64,0,41,43,87,93,42.0,2,90.0,6
2009-02-21 12:00:00,242.24,1026.4,0,64,925,41,43,87,93,42.0,2,90.0,6
2009-02-21 18:00:00,346.348,1444.4,1067,65,2442,45,48,66,81,46.5,3,73.5,15
2009-02-22 00:00:00,169.998,700.0,0,69,616,39,48,66,87,43.5,9,76.5,21
2009-02-22 06:00:00,136.386,552.0,0,92,0,37,43,87,93,40.0,6,90.0,6
2009-02-22 12:00:00,219.394,895.6,0,63,1552,43,45,81,93,44.0,2,87.0,12
2009-02-22 18:00:00,595.636,2522.0,1127,3257,2335,46,48,76,93,47.0,2,84.5,17
2009-02-23 00:00:00,1287.062,5440.4,2689,5164,3246,46,46,87,93,46.0,0,90.0,6
2009-02-23 06:00:00,497.008,2019.2,0,150,0,43,46,87,100,44.5,3,93.5,13
2009-02-23 12:00:00,867.892,3622.2,0,1449,4773,43,45,81,93,44.0,2,87.0,12
2009-02-23 18:00:00,520.11,2144.0,0,101,4804,45,46,76,87,45.5,1,81.5,11
2009-02-24 00:00:00,848.646,3551.8,1212,2044,2894,43,46,76,87,44.5,3,81.5,11
2009-02-24 06:00:00,186.048,781.4,0,122,1297,43,45,81,100,44.0,2,90.5,19
2009-02-24 12:00:00,646.41,2715.6,0,1286,4700,45,45,81,93,45.0,0,87.0,12
2009-02-24 18:00:00,501.864,2069.0,0,101,6379,45,45,66,81,45.0,0,73.5,15
2009-02-25 00:00:00,448.822,1875.4,0,93,2136,41,43,66,70,42.0,2,68.0,4
2009-02-25 06:00:00,151.928,637.0,0,63,640,32,41,70,87,36.5,9,78.5,17
2009-02-25 12:00:00,518.7379999999999,2176.0,1092,60,4258,30,45,66,100,37.5,15,83.0,34
2009-02-25 18:00:00,169.168,707.4,0,87,1108,46,52,47,57,49.0,6,52.0,10
2009-02-26 00:00:00,330.01,1393.6,0,64,1353,37,48,54,87,42.5,11,70.5,33
2009-02-26 06:00:00,136.556,576.0,0,60,589,32,36,93,100,34.0,4,96.5,7
2009-02-26 12:00:00,464.63,1931.6,0,60,4576,32,43,87,100,37.5,11,93.5,13
2009-02-26 18:00:00,176.29000000000002,737.8,0,61,838,45,48,71,81,46.5,3,76.0,10
2009-02-27 00:00:00,379.376,1597.4,0,87,838,43,46,76,87,44.5,3,81.5,11
2009-02-27 06:00:00,188.408,798.8,0,65,752,34,41,87,100,37.5,7,93.5,13
2009-02-27 12:00:00,408.16,1724.2,0,60,2351,34,41,93,100,37.5,7,96.5,7
2009-02-27 18:00:00,758.242,3166.4,1154,60,6486,41,46,81,93,43.5,5,87.0,12
2009-02-28 00:00:00,674.1080000000001,2811.6000000000004,0,61,5242,37,46,87,100,41.5,9,93.5,13
2009-02-28 06:00:00,138.41,628.0,0,60,0,34,36,93,100,35.0,2,96.5,7
2009-02-28 12:00:00,441.936,1865.0,0,829,3859,36,41,100,100,38.5,5,100.0,0
2009-02-28 18:00:00,488.228,2082.6,0,2189,2840,48,57,63,93,52.5,9,78.0,30
2009-03-01 00:00:00,562.176,2385.8,1145,2280,1307,46,55,67,87,50.5,9,77.0,20
2009-03-01 06:00:00,135.714,591.4,0,74,146,39,43,87,100,41.0,4,93.5,13
2009-03-01 12:00:00,709.688,3002.6,3913,2077,2320,39,46,87,100,42.5,7,93.5,13
2009-03-01 18:00:00,1006.186,4188.8,5385,495,4694,52,55,63,76,53.5,3,69.5,13
2009-03-02 00:00:00,616.038,2609.2000000000003,1880,94,1674,41,50,76,93,45.5,9,84.5,17
2009-03-02 06:00:00,153.092,663.0,0,64,507,41,45,87,100,43.0,4,93.5,13
2009-03-02 12:00:00,503.118,2124.4,0,93,4453,43,46,81,93,44.5,3,87.0,12
2009-03-02 18:00:00,379.634,1684.4,1560,63,775,50,54,41,71,52.0,4,56.0,30
2009-03-03 00:00:00,441.598,1865.8,0,90,949,36,50,54,87,43.0,14,70.5,33
2009-03-03 06:00:00,157.93200000000002,676.2,0,59,639,32,37,87,93,34.5,5,90.0,6
2009-03-03 12:00:00,699.816,2915.4,1159,58,5687,32,46,71,100,39.0,14,85.5,29
2009-03-03 18:00:00,500.744,2068.0,0,82,5772,50,54,51,62,52.0,4,56.5,11
2009-03-04 00:00:00,490.46,2040.2,0,69,926,45,50,50,61,47.5,5,55.5,11
2009-03-04 06:00:00,161.308,694.4,0,61,726,43,45,61,70,44.0,2,65.5,9
2009-03-04 12:00:00,605.988,2524.6,0,412,5332,39,41,81,100,40.0,2,90.5,19
2009-03-04 18:00:00,376.014,1607.8,1160,2005,130,41,45,76,93,43.0,4,84.5,17
2009-03-05 00:00:00,698.8199999999999,2945.2,1054,92,2205,34,39,87,100,36.5,5,93.5,13
2009-03-05 06:00:00,180.328,795.8,0,60,644,32,34,93,100,33.0,2,96.5,7
2009-03-05 12:00:00,543.48,2280.8,0,60,5196,30,32,93,100,31.0,2,96.5,7
2009-03-05 18:00:00,285.416,1201.8,0,91,2367,34,43,70,100,38.5,9,85.0,30
2009-03-06 00:00:00,432.588,1846.4,0,60,887,36,43,70,93,39.5,7,81.5,23
2009-03-06 06:00:00,185.118,801.4,0,59,831,37,37,81,87,37.0,0,84.0,6
2009-03-06 12:00:00,550.388,2320.0,0,58,5309,37,43,70,87,40.0,6,78.5,17
2009-03-06 18:00:00,455.29,1968.6,0,89,3697,45,50,40,61,47.5,5,50.5,21
2009-03-07 00:00:00,592.678,2489.6,1144,59,2219,34,46,50,81,40.0,12,65.5,31
2009-03-07 06:00:00,150.236,645.8,0,58,512,30,34,87,100,32.0,4,93.5,13
2009-03-07 12:00:00,483.154,2016.4,5,58,3759,36,43,76,81,39.5,7,78.5,5
2009-03-07 18:00:00,553.5799999999999,2316.4,1050,592,4256,46,52,67,82,49.0,6,74.5,15
2009-03-08 00:00:00,509.496,2129.2,0,103,3586,45,48,82,93,46.5,3,87.5,11
2009-03-08 06:00:00,186.342,778.2,0,61,889,45,46,87,93,45.5,1,90.0,6
2009-03-08 12:00:00,610.7339999999999,2606.8,2835,1362,2786,46,48,93,93,47.0,2,93.0,0
2009-03-08 18:00:00,828.876,3454.2,3397,1103,6464,48,50,71,100,49.0,2,85.5,29
2009-03-09 00:00:00,731.2139999999999,3070.6000000000004,1021,2734,2552,41,50,54,87,45.5,9,70.5,33
2009-03-09 06:00:00,136.07,581.6,0,148,402,37,41,76,87,39.0,4,81.5,11
2009-03-09 12:00:00,533.522,2203.2,0,64,5617,37,46,66,87,41.5,9,76.5,21
2009-03-09 18:00:00,455.306,1916.6,905,69,3435,45,50,50,87,47.5,5,68.5,37
2009-03-10 00:00:00,560.658,2361.0,1096,88,882,41,46,62,76,43.5,5,69.0,14
2009-03-10 06:00:00,167.112,714.6,0,63,752,41,43,70,87,42.0,2,78.5,17
2009-03-10 12:00:00,652.218,2756.2,0,69,5630,41,45,93,100,43.0,4,96.5,7
2009-03-10 18:00:00,433.616,1792.6,0,87,4429,48,54,58,87,51.0,6,72.5,29
2009-03-11 00:00:00,583.264,2427.2,0,62,799,48,52,62,82,50.0,4,72.0,20
2009-03-11 06:00:00,357.332,1495.2,0,92,92,37,48,81,93,42.5,11,87.0,12
2009-03-11 12:00:00,830.412,3483.6,2384,475,5635,34,48,66,100,41.0,14,83.0,34
2009-03-11 18:00:00,667.95,2780.6,5,3989,3757,48,54,44,54,51.0,6,49.0,10
2009-03-12 00:00:00,550.21,2360.4,1087,2732,1253,43,52,47,76,47.5,9,61.5,29
2009-03-12 06:00:00,143.902,610.0,0,130,611,41,43,70,81,42.0,2,75.5,11
2009-03-12 12:00:00,738.472,3085.6,0,76,5899,43,50,71,100,46.5,7,85.5,29
2009-03-12 18:00:00,593.772,2453.0,0,79,6319,52,55,72,88,53.5,3,80.0,16
2009-03-13 00:00:00,411.114,1710.8,0,79,826,50,54,71,76,52.0,4,73.5,5
2009-03-13 06:00:00,149.316,621.4000000000001,0,69,743,43,48,71,87,45.5,5,79.0,16
2009-03-13 12:00:00,541.5459999999999,2235.0,0,86,5236,45,52,71,87,48.5,7,79.0,16
2009-03-13 18:00:00,274.288,1158.6,1082,63,1009,52,55,54,67,53.5,3,60.5,13
2009-03-14 00:00:00,480.37,1991.8,0,93,3478,43,54,58,87,48.5,11,72.5,29
2009-03-14 06:00:00,135.072,562.8,0,62,544,39,45,87,93,42.0,6,90.0,6
2009-03-14 12:00:00,575.9780000000001,2388.4,1071,86,5344,41,54,72,93,47.5,13,82.5,21
2009-03-14 18:00:00,481.084,1971.0,0,70,5832,52,55,62,82,53.5,3,72.0,20
2009-03-15 00:00:00,956.894,3985.8,1125,62,6316,48,52,54,71,50.0,4,62.5,17
2009-03-15 06:00:00,339.504,1409.0,0,91,3224,41,46,76,87,43.5,5,81.5,11
2009-03-15 12:00:00,505.948,2157.0,2404,1155,1468,37,54,54,93,45.5,17,73.5,39
2009-03-15 18:00:00,500.816,2137.6,0,3748,1679,54,57,48,51,55.5,3,49.5,3
2009-03-16 00:00:00,595.794,2499.0,1074,158,1982,45,57,51,76,51.0,12,63.5,25
2009-03-16 06:00:00,108.752,460.4,0,61,0,41,45,76,93,43.0,4,84.5,17
2009-03-16 12:00:00,542.126,2228.4,0,91,6124,39,52,58,93,45.5,13,75.5,35
2009-03-16 18:00:00,211.714,874.4,0,62,1784,52,59,51,58,55.5,7,54.5,7
2009-03-17 00:00:00,472.14,1974.2,0,92,1365,46,57,51,76,51.5,11,63.5,25
2009-03-17 06:00:00,146.71,614.6,0,60,711,37,43,87,100,40.0,6,93.5,13
2009-03-17 12:00:00,594.754,2534.4,1110,85,5217,41,52,67,93,46.5,11,80.0,26
2009-03-17 18:00:00,457.242,1902.8,0,68,5231,55,61,45,58,58.0,6,51.5,13
2009-03-18 00:00:00,733.204,3083.2000000000003,0,3739,1161,50,57,51,76,53.5,7,63.5,25
2009-03-18 06:00:00,149.30599999999998,631.8,0,153,681,45,50,76,81,47.5,5,78.5,5
2009-03-18 12:00:00,518.5,2139.6,0,62,5681,43,52,62,81,47.5,9,71.5,19
2009-03-18 18:00:00,352.53,1460.0,0,96,3673,55,63,30,51,59.0,8,40.5,21
2009-03-19 00:00:00,430.344,1789.4,1123,64,2066,48,59,31,41,53.5,11,36.0,10
2009-03-19 06:00:00,116.106,486.4,0,94,184,39,46,37,56,42.5,7,46.5,19
2009-03-19 12:00:00,511.604,2115.8,0,62,5786,39,54,33,61,46.5,15,47.0,28
2009-03-19 18:00:00,297.74,1225.4,0,90,3226,57,61,20,29,59.0,4,24.5,9
2009-03-20 00:00:00,266.082,1104.2,0,68,262,46,57,38,66,51.5,11,52.0,28
2009-03-20 06:00:00,150.572,628.4,0,89,723,39,45,66,70,42.0,6,68.0,4
2009-03-20 12:00:00,482.93,1983.8,0,65,5460,37,48,43,70,42.5,11,56.5,27
2009-03-20 18:00:00,303.178,1257.6,0,78,2993,50,54,30,38,52.0,4,34.0,8
2009-03-21 00:00:00,527.226,2203.8,1083,76,1442,39,50,32,52,44.5,11,42.0,20
2009-03-21 06:00:00,101.704,421.8,0,59,0,32,41,45,64,36.5,9,54.5,19
2009-03-21 12:00:00,512.458,2121.8,1142,490,4465,28,48,34,70,38.0,20,52.0,36
2009-03-21 18:00:00,461.244,2007.2,2487,73,1764,48,54,24,34,51.0,6,29.0,10
2009-03-22 00:00:00,854.616,3616.6,1791,60,4037,39,52,28,52,45.5,13,40.0,24
2009-03-22 06:00:00,142.52,613.0,0,90,494,34,41,60,81,37.5,7,70.5,21
2009-03-22 12:00:00,168.20000000000002,726.2,0,60,0,32,45,81,87,38.5,13,84.0,6
2009-03-22 18:00:00,899.15,3802.8,2017,3567,4258,45,50,66,76,47.5,5,71.0,10
2009-03-23 00:00:00,479.3,1986.8,0,61,4263,39,50,62,87,44.5,11,74.5,25
2009-03-23 06:00:00,163.524,690.4,0,92,0,36,41,87,93,38.5,5,90.0,6
2009-03-23 12:00:00,522.864,2185.6,0,61,4425,37,46,81,93,41.5,9,87.0,12
2009-03-23 18:00:00,138.022,590.0,0,94,0,50,59,39,71,54.5,9,55.0,32
2009-03-24 00:00:00,472.04,1990.8,1078,63,1574,46,57,41,87,51.5,11,64.0,46
2009-03-24 06:00:00,165.338,725.4000000000001,0,62,671,41,45,61,76,43.0,4,68.5,15
2009-03-24 12:00:00,616.678,2594.2,0,92,5749,37,45,66,87,41.0,8,76.5,21
2009-03-24 18:00:00,244.494,1033.2,0,62,1986,45,50,43,61,47.5,5,52.0,18
2009-03-25 00:00:00,635.202,2695.0,1710,136,1743,37,46,50,75,41.5,9,62.5,25
2009-03-25 06:00:00,113.52,482.4,0,139,87,37,41,75,81,39.0,4,78.0,6
2009-03-25 12:00:00,672.172,2770.8,1049,515,5973,39,46,87,93,42.5,7,90.0,6
2009-03-25 18:00:00,357.924,1544.6,0,2565,809,46,54,54,87,50.0,8,70.5,33
2009-03-26 00:00:00,695.158,2910.6000000000004,1731,96,3418,46,50,58,76,48.0,4,67.0,18
2009-03-26 06:00:00,103.316,430.2,0,63,0,43,45,76,87,44.0,2,81.5,11
2009-03-26 12:00:00,522.922,2149.2,0,68,6013,43,50,71,87,46.5,7,79.0,16
2009-03-26 18:00:00,159.482,666.8000000000001,0,91,775,48,50,71,87,49.0,2,79.0,16
2009-03-27 00:00:00,425.28399999999993,1796.2,0,90,1808,48,50,76,87,49.0,2,81.5,11
2009-03-27 06:00:00,136.778,640.4,0,151,0,45,48,81,93,46.5,3,87.0,12
2009-03-27 12:00:00,616.8299999999999,2559.2000000000003,1103,142,5370,43,48,66,87,45.5,5,76.5,21
2009-03-27 18:00:00,345.896,1453.6,0,138,3086,50,52,54,66,51.0,2,60.0,12
2009-03-28 00:00:00,614.422,2568.6,0,95,1491,46,52,54,76,49.0,6,65.0,22
2009-03-28 06:00:00,156.394,681.2,0,70,594,43,46,76,93,44.5,3,84.5,17
2009-03-28 12:00:00,558.604,2320.2,1058,95,5121,41,48,62,93,44.5,7,77.5,31
2009-03-28 18:00:00,565.89,2393.6,1017,98,3513,43,52,58,87,47.5,9,72.5,29
2009-03-29 00:00:00,980.088,4113.8,2452,64,2997,39,46,71,87,42.5,7,79.0,16
2009-03-29 06:00:00,444.0,1838.0,552,64,0,36,39,87,93,37.5,3,90.0,6
2009-03-29 12:00:00,482.92,1998.4,0,619,1314,36,45,66,93,40.5,9,79.5,27
2009-03-29 18:00:00,702.104,2932.6,1059,2081,5090,46,50,47,62,48.0,4,54.5,15
2009-03-30 00:00:00,587.626,2473.4,0,1260,3098,39,46,53,75,42.5,7,64.0,22
2009-03-30 06:00:00,160.196,688.0,0,75,619,36,39,70,75,37.5,3,72.5,5
2009-03-30 12:00:00,526.99,2182.2,0,62,5302,36,48,43,81,42.0,12,62.0,38
2009-03-30 18:00:00,279.278,1175.8,0,83,2530,50,54,35,40,52.0,4,37.5,5
2009-03-31 00:00:00,510.988,2152.8,1085,75,1450,37,50,40,81,43.5,13,60.5,41
2009-03-31 06:00:00,132.386,581.0,0,62,89,37,41,65,75,39.0,4,70.0,10
2009-03-31 12:00:00,598.272,2487.8,0,85,5981,39,52,50,70,45.5,13,60.0,20
2009-03-31 18:00:00,618.224,2577.0,2202,71,5728,55,57,33,41,56.0,2,37.0,8
2009-04-01 00:00:00,474.6,1999.2,0,2493,1160,41,57,36,61,49.0,16,48.5,25
2009-04-01 06:00:00,314.598,1315.0,0,113,662,43,48,62,70,45.5,5,66.0,8
2009-04-01 12:00:00,631.37,2637.0,0,2067,4750,41,54,51,76,47.5,13,63.5,25
2009-04-01 18:00:00,173.694,761.8,807,97,0,57,63,32,44,60.0,6,38.0,12
2009-04-02 00:00:00,521.478,2209.6,2000,87,1897,50,61,31,54,55.5,11,42.5,23
2009-04-02 06:00:00,153.39,665.2,0,81,427,45,50,62,76,47.5,5,69.0,14
2009-04-02 12:00:00,554.374,2297.6,0,79,5651,45,57,54,76,51.0,12,65.0,22
2009-04-02 18:00:00,447.272,1834.4,0,78,5377,61,64,49,55,62.5,3,52.0,6
2009-04-03 00:00:00,489.298,2059.2000000000003,1128,86,2045,50,64,52,72,57.0,14,62.0,20
2009-04-03 06:00:00,159.82999999999998,695.6,0,97,591,45,50,82,93,47.5,5,87.5,11
2009-04-03 12:00:00,469.88,1960.0,0,64,4245,50,54,77,87,52.0,4,82.0,10
2009-04-03 18:00:00,362.786,1528.4,0,98,2959,54,64,56,77,59.0,10,66.5,21
2009-04-04 00:00:00,370.764,1551.4,0,67,761,54,63,59,72,58.5,9,65.5,13
2009-04-04 06:00:00,134.78199999999998,613.0,0,97,0,48,54,77,87,51.0,6,82.0,10
2009-04-04 12:00:00,535.482,2238.0,0,557,5053,45,54,62,87,49.5,9,74.5,25
2009-04-04 18:00:00,787.752,3296.4,2699,1730,4849,55,57,55,63,56.0,2,59.0,8
2009-04-05 00:00:00,733.216,3063.6,0,1788,6349,54,57,63,72,55.5,3,67.5,9
2009-04-05 06:00:00,199.564,865.4,0,97,1046,46,50,87,93,48.0,4,90.0,6
2009-04-05 12:00:00,468.81,1998.6,1544,64,2783,46,55,72,93,50.5,9,82.5,21
2009-04-05 18:00:00,355.164,1550.2,1239,98,1413,57,61,48,67,59.0,4,57.5,19
2009-04-06 00:00:00,352.178,1507.1999999999998,1049,98,1261,50,59,51,82,54.5,9,66.5,31
2009-04-06 06:00:00,160.0,685.8,0,68,540,50,50,82,82,50.0,0,82.0,0
2009-04-06 12:00:00,516.612,2145.8,0,98,5441,50,50,82,82,50.0,0,82.0,0
2009-04-06 18:00:00,301.372,1256.0,0,66,2939,50,50,82,82,50.0,0,82.0,0
2009-04-07 00:00:00,474.65,1997.2,799,101,1221,50,50,82,82,50.0,0,82.0,0
2009-04-07 06:00:00,153.49599999999998,668.4,0,100,392,52,54,94,94,53.0,2,94.0,0
2009-04-07 12:00:00,580.668,2445.6,0,65,5436,50,54,82,100,52.0,4,91.0,18
2009-04-07 18:00:00,214.006,909.4,0,99,1484,55,59,48,72,57.0,4,60.0,24
2009-04-08 00:00:00,491.922,2069.6,1103,74,1809,52,59,42,63,55.5,7,52.5,21
2009-04-08 06:00:00,195.044,841.6,0,90,1221,45,48,76,87,46.5,3,81.5,11
2009-04-08 12:00:00,544.9780000000001,2291.8,1106,393,4380,45,50,87,93,47.5,5,90.0,6
2009-04-08 18:00:00,363.01,1569.8000000000002,0,2274,1036,50,55,82,94,52.5,5,88.0,12
2009-04-09 00:00:00,431.568,1817.0,1025,70,1331,50,55,66,94,52.5,5,80.0,28
2009-04-09 06:00:00,182.184,758.8,0,98,1045,54,54,88,94,54.0,0,91.0,6
2009-04-09 12:00:00,633.368,2631.8,0,99,6133,54,57,77,88,55.5,3,82.5,11
2009-04-09 18:00:00,266.36,1100.4,0,73,2252,59,70,38,77,64.5,11,57.5,39
2009-04-10 00:00:00,808.5600000000001,3378.0,2682,96,4052,54,70,35,94,62.0,16,64.5,59
2009-04-10 06:00:00,171.60399999999998,723.8000000000001,0,102,1041,55,63,52,67,59.0,8,59.5,15
2009-04-10 12:00:00,639.678,2656.2,1067,514,5993,54,66,49,72,60.0,12,60.5,23
2009-04-10 18:00:00,385.508,1601.8,0,77,4141,61,68,46,59,64.5,7,52.5,13
2009-04-11 00:00:00,645.324,2692.2,990,2129,2653,55,61,55,77,58.0,6,66.0,22
2009-04-11 06:00:00,135.364,575.2,0,135,400,50,54,77,87,52.0,4,82.0,10
2009-04-11 12:00:00,653.52,2737.2,0,2113,5811,52,64,49,82,58.0,12,65.5,33
2009-04-11 18:00:00,601.684,2524.0,0,1797,5227,61,68,40,55,64.5,7,47.5,15
2009-04-12 00:00:00,1071.8780000000002,4496.0,3661,241,6795,55,59,67,82,57.0,4,74.5,15
2009-04-12 06:00:00,378.838,1571.2,0,312,4290,52,54,88,100,53.0,2,94.0,12
2009-04-12 12:00:00,477.866,2011.6,1067,236,3671,52,59,82,94,55.5,7,88.0,12
2009-04-12 18:00:00,274.646,1206.8,0,288,1302,63,66,60,77,64.5,3,68.5,17
2009-04-13 00:00:00,1009.662,4329.6,6431,668,3207,55,64,59,82,59.5,9,70.5,23
2009-04-13 06:00:00,186.28,810.6,0,97,934,50,55,82,94,52.5,5,88.0,12
2009-04-13 12:00:00,477.86,2038.8,0,1699,2347,48,55,77,100,51.5,7,88.5,23
2009-04-13 18:00:00,244.592,1048.4,0,151,1137,59,68,52,72,63.5,9,62.0,20
2009-04-14 00:00:00,689.892,2915.2,1006,3701,1791,55,63,59,88,59.0,8,73.5,29
2009-04-14 06:00:00,155.246,685.6,0,184,410,48,55,82,100,51.5,7,91.0,18
2009-04-14 12:00:00,549.31,2316.6,0,105,5783,48,64,64,100,56.0,16,82.0,36
2009-04-14 18:00:00,212.686,916.4,0,116,1351,66,68,49,56,67.0,2,52.5,7
2009-04-15 00:00:00,584.296,2467.8,888,1936,1934,55,66,56,82,60.5,11,69.0,26
2009-04-15 06:00:00,196.35,844.0,0,162,407,55,59,88,94,57.0,4,91.0,6
2009-04-15 12:00:00,303.11400000000003,1288.2,0,99,2158,54,64,52,88,59.0,10,70.0,36
2009-04-15 18:00:00,188.366,820.8,0,89,1014,64,70,35,49,67.0,6,42.0,14
2009-04-16 00:00:00,528.232,2246.8,1880,113,1699,54,68,35,82,61.0,14,58.5,47
2009-04-16 06:00:00,194.088,850.4,0,109,1054,50,52,76,94,51.0,2,85.0,18
2009-04-16 12:00:00,495.022,2070.2,0,109,5687,50,54,82,94,52.0,4,88.0,12
2009-04-16 18:00:00,163.888,722.0,0,98,607,55,57,59,77,56.0,2,68.0,18
2009-04-17 00:00:00,711.5260000000001,3016.2000000000003,2896,81,2461,48,57,59,82,52.5,9,70.5,23
2009-04-17 06:00:00,528.316,2187.4,0,107,498,46,46,87,87,46.0,0,87.0,0
2009-04-17 12:00:00,505.046,2123.6,0,105,3615,45,57,59,93,51.0,12,76.0,34
2009-04-17 18:00:00,277.314,1201.4,0,106,2089,59,61,48,59,60.0,2,53.5,11
2009-04-18 00:00:00,732.134,3080.0,0,4906,1453,46,59,55,87,52.5,13,71.0,32
2009-04-18 06:00:00,214.564,929.4,0,532,929,45,48,82,93,46.5,3,87.5,11
2009-04-18 12:00:00,558.3679999999999,2367.6,497,1885,3612,46,52,82,94,49.0,6,88.0,12
2009-04-18 18:00:00,458.246,1891.2,531,104,5039,52,54,82,94,53.0,2,88.0,12
2009-04-19 00:00:00,281.088,1188.2,0,92,1119,50,52,71,100,51.0,2,85.5,29
2009-04-19 06:00:00,186.758,781.2,0,79,1134,50,52,88,94,51.0,2,91.0,6
2009-04-19 12:00:00,276.464,1166.0,0,102,2334,50,54,82,94,52.0,4,88.0,12
2009-04-19 18:00:00,308.822,1271.0,0,102,3427,55,63,48,77,59.0,8,62.5,29
2009-04-20 00:00:00,514.424,2179.6000000000004,2201,93,1193,52,61,52,100,56.5,9,76.0,48
2009-04-20 06:00:00,139.29399999999998,584.6,0,77,521,48,50,82,87,49.0,2,84.5,5
2009-04-20 12:00:00,620.1700000000001,2593.4,0,1028,6277,50,64,56,87,57.0,14,71.5,31
2009-04-20 18:00:00,335.916,1400.8,0,1363,2225,66,68,46,52,67.0,2,49.0,6
2009-04-21 00:00:00,391.13,1661.2,0,176,1453,52,64,52,82,58.0,12,67.0,30
2009-04-21 06:00:00,529.9780000000001,2199.2,0,94,1084,48,54,77,87,51.0,6,82.0,10
2009-04-21 12:00:00,549.004,2321.0,1015,74,3729,48,61,63,93,54.5,13,78.0,30
2009-04-21 18:00:00,218.376,960.2,0,103,1229,64,68,46,56,66.0,4,51.0,10
2009-04-22 00:00:00,597.24,2490.4,910,104,1338,54,64,48,77,59.0,10,62.5,29
2009-04-22 06:00:00,169.374,717.4,0,101,958,46,52,71,87,49.0,6,79.0,16
2009-04-22 12:00:00,544.5360000000001,2277.2,491,97,5724,45,61,52,93,53.0,16,72.5,41
2009-04-22 18:00:00,608.9399999999999,2537.0,533,911,6133,63,66,40,52,64.5,3,46.0,12
2009-04-23 00:00:00,173.348,765.2,0,94,450,54,64,48,67,59.0,10,57.5,19
2009-04-23 06:00:00,211.588,913.0,0,101,1275,43,50,71,81,46.5,7,76.0,10
2009-04-23 12:00:00,257.52,1113.4,0,99,1696,43,59,36,87,51.0,16,61.5,51
2009-04-23 18:00:00,199.628,870.4,0,103,1203,61,64,24,31,62.5,3,27.5,7
2009-04-24 00:00:00,472.724,2002.4,1068,92,1337,54,64,24,67,59.0,10,45.5,43
2009-04-24 06:00:00,190.18,824.4,0,76,1103,45,52,58,76,48.5,7,67.0,18
2009-04-24 12:00:00,476.9980000000001,1999.4,0,100,5286,43,59,39,81,51.0,16,60.0,42
2009-04-24 18:00:00,280.03,1203.8,0,102,2083,59,64,32,40,61.5,5,36.0,8
2009-04-25 00:00:00,246.84,1055.4,0,105,1205,52,63,34,58,57.5,11,46.0,24
2009-04-25 06:00:00,170.446,726.6,0,102,926,46,50,62,71,48.0,4,66.5,9
2009-04-25 12:00:00,594.954,2553.2,0,3496,3622,48,55,58,82,51.5,7,70.0,24
2009-04-25 18:00:00,677.458,2842.6,1061,209,6752,52,55,58,88,53.5,3,73.0,30
2009-04-26 00:00:00,579.426,2425.6,946,94,1925,50,52,58,88,51.0,2,73.0,30
2009-04-26 06:00:00,189.544,813.8,0,103,401,48,48,93,93,48.0,0,93.0,0
2009-04-26 12:00:00,475.676,2003.0,0,581,4290,48,54,77,94,51.0,6,85.5,17
2009-04-26 18:00:00,809.52,3420.4,3053,2228,4762,55,59,59,72,57.0,4,65.5,13
2009-04-27 00:00:00,306.886,1311.4,0,105,1108,48,57,63,93,52.5,9,78.0,30
2009-04-27 06:00:00,177.21,772.6,0,99,889,46,52,76,87,49.0,6,81.5,11
2009-04-27 12:00:00,467.616,1979.0,995,70,3527,46,54,62,93,50.0,8,77.5,31
2009-04-27 18:00:00,193.9,856.2,0,103,1008,54,59,55,67,56.5,5,61.0,12
2009-04-28 00:00:00,512.9019999999999,2158.2,0,104,1597,46,57,67,94,51.5,11,80.5,27
2009-04-28 06:00:00,227.774,973.6,0,100,976,39,45,93,100,42.0,6,96.5,7
2009-04-28 12:00:00,629.592,2739.4,0,67,5866,41,50,71,100,45.5,9,85.5,29
2009-04-28 18:00:00,408.82,1717.2,1027,102,3312,52,55,58,71,53.5,3,64.5,13
2009-04-29 00:00:00,440.2,1854.8,1041,102,1315,45,50,76,93,47.5,5,84.5,17
2009-04-29 06:00:00,146.472,643.4,0,88,345,45,46,93,100,45.5,1,96.5,7
2009-04-29 12:00:00,554.77,2314.6,0,82,5384,45,52,76,100,48.5,7,88.0,24
2009-04-29 18:00:00,389.408,1632.8,1043,101,2543,52,57,58,82,54.5,5,70.0,24
2009-04-30 00:00:00,574.03,2405.4,0,2221,1100,46,54,71,93,50.0,8,82.0,22
2009-04-30 06:00:00,194.134,843.6,0,99,1010,39,43,93,100,41.0,4,96.5,7
2009-04-30 12:00:00,572.474,2375.0,1027,73,5783,41,61,63,100,51.0,20,81.5,37
2009-04-30 18:00:00,388.606,1620.2,0,91,4258,63,64,42,52,63.5,1,47.0,10
2009-05-01 00:00:00,679.548,2827.6,0,100,4254,45,61,52,93,53.0,16,72.5,41
2009-05-01 06:00:00,450.464,1851.2,0,98,5353,41,46,87,100,43.5,5,93.5,13
2009-05-01 12:00:00,347.836,1477.4,0,158,2421,41,66,49,100,53.5,25,74.5,51
2009-05-01 18:00:00,377.56,1602.6,0,694,2422,66,68,43,49,67.0,2,46.0,6
2009-05-02 00:00:00,336.942,1439.6,1067,102,1513,48,68,37,82,58.0,20,59.5,45
2009-05-02 06:00:00,143.452,611.8,0,99,627,43,54,76,87,48.5,11,81.5,11
2009-05-02 12:00:00,504.444,2123.8,359,98,4982,43,59,72,93,51.0,16,82.5,21
2009-05-02 18:00:00,416.096,1758.6,1071,99,2762,63,64,64,72,63.5,1,68.0,8
2009-05-03 00:00:00,329.918,1377.4,0,78,1389,52,63,63,88,57.5,11,75.5,25
2009-05-03 06:00:00,124.944,537.2,0,89,406,48,55,72,94,51.5,7,83.0,22
2009-05-03 12:00:00,481.738,2052.6,1795,98,3864,46,54,67,93,50.0,8,80.0,26
2009-05-03 18:00:00,287.26800000000003,1250.8,315,479,349,55,59,59,77,57.0,4,68.0,18
2009-05-04 00:00:00,714.928,3016.6,1097,1927,2607,52,55,71,82,53.5,3,76.5,11
2009-05-04 06:00:00,326.596,1386.8,0,148,349,43,48,82,93,45.5,5,87.5,11
2009-05-04 12:00:00,570.122,2356.8,0,99,5955,41,57,48,93,49.0,16,70.5,45
2009-05-04 18:00:00,252.898,1048.4,0,79,2362,59,61,34,42,60.0,2,38.0,8
2009-05-05 00:00:00,518.2660000000001,2179.6,1007,85,2708,48,57,41,82,52.5,9,61.5,41
2009-05-05 06:00:00,125.612,535.2,0,99,344,45,50,62,81,47.5,5,71.5,19
2009-05-05 12:00:00,580.896,2421.8,0,324,6204,48,55,82,87,51.5,7,84.5,5
2009-05-05 18:00:00,475.21,2014.6,0,3233,2221,55,61,68,82,58.0,6,75.0,14
2009-05-06 00:00:00,549.756,2310.8,1049,1883,1397,50,63,62,72,56.5,13,67.0,10
2009-05-06 06:00:00,142.778,615.8,0,103,396,48,55,76,88,51.5,7,82.0,12
2009-05-06 12:00:00,522.54,2174.4,0,99,6178,48,55,67,87,51.5,7,77.0,20
2009-05-06 18:00:00,249.136,1071.2,0,324,1124,57,61,63,67,59.0,4,65.0,4
2009-05-07 00:00:00,435.448,1855.0,1038,1271,1360,54,61,63,82,57.5,7,72.5,19
2009-05-07 06:00:00,127.986,544.4,0,99,389,45,46,93,100,45.5,1,96.5,7
2009-05-07 12:00:00,411.354,1722.8,0,100,4692,45,68,52,100,56.5,23,76.0,48
2009-05-07 18:00:00,136.706,619.0,0,82,400,70,75,47,57,72.5,5,52.0,10
2009-05-08 00:00:00,336.602,1394.6,0,93,2511,63,75,47,82,69.0,12,64.5,35
2009-05-08 06:00:00,137.362,584.2,0,104,405,54,61,82,88,57.5,7,85.0,6
2009-05-08 12:00:00,417.422,1766.8,0,321,3609,54,59,77,88,56.5,5,82.5,11
2009-05-08 18:00:00,672.316,2802.4,1018,319,5554,59,66,49,72,62.5,7,60.5,23
2009-05-09 00:00:00,630.0559999999999,2648.2,1208,104,5858,54,63,55,94,58.5,9,74.5,39
2009-05-09 06:00:00,148.554,648.4,0,102,411,50,54,58,71,52.0,4,64.5,13
2009-05-09 12:00:00,483.814,2041.8,771,102,4232,50,61,68,77,55.5,11,72.5,9
2009-05-09 18:00:00,365.466,1593.2,1319,95,986,57,61,68,94,59.0,4,81.0,26
2009-05-10 00:00:00,263.51800000000003,1137.4,0,83,976,52,61,67,94,56.5,9,80.5,27
2009-05-10 06:00:00,184.358,805.1999999999999,0,95,978,50,52,100,100,51.0,2,100.0,0
2009-05-10 12:00:00,299.448,1309.2,36,403,1927,50,63,68,100,56.5,13,84.0,32
2009-05-10 18:00:00,713.39,3031.8,2605,4345,2148,64,68,64,68,66.0,4,66.0,4
2009-05-11 00:00:00,769.356,3263.2,1659,1827,3639,52,64,73,100,58.0,12,86.5,27
2009-05-11 06:00:00,149.54399999999998,642.6,0,148,638,57,59,94,100,58.0,2,97.0,6
2009-05-11 12:00:00,521.452,2171.4,0,108,5943,57,59,88,94,58.0,2,91.0,6
2009-05-11 18:00:00,133.404,576.2,0,102,398,57,61,82,94,59.0,4,88.0,12
2009-05-12 00:00:00,712.7760000000001,2990.4,1035,99,4030,57,61,82,100,59.0,4,91.0,18
2009-05-12 06:00:00,176.292,771.8,0,99,674,54,55,94,94,54.5,1,94.0,0
2009-05-12 12:00:00,644.766,2688.6,0,107,6752,54,63,88,100,58.5,9,94.0,12
2009-05-12 18:00:00,232.092,998.8,0,108,1685,64,68,64,77,66.0,4,70.5,13
2009-05-13 00:00:00,572.806,2408.0,0,2399,2224,57,68,64,88,62.5,11,76.0,24
2009-05-13 06:00:00,158.598,699.6,0,203,453,57,57,88,94,57.0,0,91.0,6
2009-05-13 12:00:00,488.824,2082.4,0,119,4977,57,66,78,94,61.5,9,86.0,16
2009-05-13 18:00:00,163.674,722.8,0,110,675,70,72,60,69,71.0,2,64.5,9
2009-05-14 00:00:00,435.302,1833.8,1419,121,1022,57,68,73,88,62.5,11,80.5,15
2009-05-14 06:00:00,161.984,687.4,0,108,1024,55,59,94,100,57.0,4,97.0,6
2009-05-14 12:00:00,500.042,2213.6,0,99,5293,57,61,94,94,59.0,4,94.0,0
2009-05-14 18:00:00,130.474,572.8,0,109,391,63,64,77,82,63.5,1,79.5,5
2009-05-15 00:00:00,814.484,3446.4,0,3749,4791,57,61,88,100,59.0,4,94.0,12
2009-05-15 06:00:00,134.866,612.8,0,176,446,55,57,94,100,56.0,2,97.0,6
2009-05-15 12:00:00,612.502,2569.6,1382,105,6108,54,57,72,94,55.5,3,83.0,22
2009-05-15 18:00:00,252.99,1089.6,0,107,2134,54,59,59,94,56.5,5,76.5,35
2009-05-16 00:00:00,421.868,1751.2,0,106,3507,46,57,55,94,51.5,11,74.5,39
2009-05-16 06:00:00,138.964,605.0,0,104,963,48,50,82,82,49.0,2,82.0,0
2009-05-16 12:00:00,507.15,2151.8,0,1907,4165,50,55,76,88,52.5,5,82.0,12
2009-05-16 18:00:00,709.67,2997.4,1705,2704,4830,55,61,82,88,58.0,6,85.0,6
2009-05-17 00:00:00,651.5939999999999,2720.8,0,105,2307,48,61,72,82,54.5,13,77.0,10
2009-05-17 06:00:00,214.226,894.8,0,103,897,50,52,88,94,51.0,2,91.0,6
2009-05-17 12:00:00,536.86,2298.4,1516,1553,2240,50,55,82,94,52.5,5,88.0,12
2009-05-17 18:00:00,343.532,1505.0,0,166,2068,55,59,72,88,57.0,4,80.0,16
2009-05-18 00:00:00,449.146,1933.6,1039,104,1963,54,61,67,88,57.5,7,77.5,21
2009-05-18 06:00:00,152.026,643.4,0,101,859,46,50,87,94,48.0,4,90.5,7
2009-05-18 12:00:00,499.72,2071.4,0,86,5819,46,59,67,93,52.5,13,80.0,26
2009-05-18 18:00:00,126.874,540.8,0,83,384,63,66,49,59,64.5,3,54.0,10
2009-05-19 00:00:00,431.286,1810.6,763,104,1909,52,64,49,94,58.0,12,71.5,45
2009-05-19 06:00:00,164.966,687.8,0,101,1021,45,50,87,93,47.5,5,90.0,6
2009-05-19 12:00:00,509.186,2129.4,0,101,5964,48,63,59,94,55.5,15,76.5,35
2009-05-19 18:00:00,185.166,788.2,0,159,1306,63,68,52,64,65.5,5,58.0,12
2009-05-20 00:00:00,758.026,3164.8,3253,431,2690,52,68,49,82,60.0,16,65.5,33
2009-05-20 06:00:00,189.95,811.2,0,428,1016,45,50,87,100,47.5,5,93.5,13
2009-05-20 12:00:00,553.198,2307.6,0,702,6096,46,68,52,100,57.0,22,76.0,48
2009-05-20 18:00:00,221.376,949.4,0,621,895,70,73,46,53,71.5,3,49.5,7
2009-05-21 00:00:00,342.638,1460.6,1061,138,1463,52,72,50,82,62.0,20,66.0,32
2009-05-21 06:00:00,149.244,644.2,0,110,588,54,59,82,94,56.5,5,88.0,12
2009-05-21 12:00:00,375.37,1577.2,216,110,2716,54,70,64,100,62.0,16,82.0,36
2009-05-21 18:00:00,656.404,2733.4,292,620,6845,70,73,53,57,71.5,3,55.0,4
2009-05-22 00:00:00,394.132,1681.4,1045,438,2414,63,70,56,68,66.5,7,62.0,12
2009-05-22 06:00:00,177.456,780.0,0,475,913,46,59,67,87,52.5,13,77.0,20
2009-05-22 12:00:00,374.684,1577.4,0,446,3947,50,63,48,82,56.5,13,65.0,34
2009-05-22 18:00:00,325.624,1416.0,982,165,2156,64,70,31,42,67.0,6,36.5,11
2009-05-23 00:00:00,197.042,836.0,0,121,1062,61,70,33,68,65.5,9,50.5,35
2009-05-23 06:00:00,126.084,544.8,0,100,459,50,57,63,82,53.5,7,72.5,19
2009-05-23 12:00:00,564.312,2366.0,0,325,6607,54,68,46,72,61.0,14,59.0,26
2009-05-23 18:00:00,385.28,1647.0,466,861,2058,63,72,46,72,67.5,9,59.0,26
2009-05-24 00:00:00,454.922,1914.2,14,558,3455,59,72,57,68,65.5,13,62.5,11
2009-05-24 06:00:00,186.6,793.2,0,107,985,55,61,77,94,58.0,6,85.5,17
2009-05-24 12:00:00,284.6,1208.8,23,103,2445,57,77,57,94,67.0,20,75.5,37
2009-05-24 18:00:00,319.116,1335.8,22,116,3109,79,82,51,61,80.5,3,56.0,10
2009-05-25 00:00:00,497.47,2091.8,0,120,3717,63,84,45,72,73.5,21,58.5,27
2009-05-25 06:00:00,164.382,696.4,0,126,1021,63,70,78,94,66.5,7,86.0,16
2009-05-25 12:00:00,436.07,1824.8,0,126,5090,66,75,65,88,70.5,9,76.5,23
2009-05-25 18:00:00,343.158,1478.6,656,451,1755,77,84,55,66,80.5,7,60.5,11
2009-05-26 00:00:00,410.486,1762.8000000000002,264,263,2064,70,84,58,78,77.0,14,68.0,20
2009-05-26 06:00:00,129.866,553.4,0,119,502,61,64,82,94,62.5,3,88.0,12
2009-05-26 12:00:00,503.792,2200.8,0,113,5716,59,63,77,88,61.0,4,82.5,11
2009-05-26 18:00:00,278.13,1200.0,0,111,3012,57,63,59,88,60.0,6,73.5,29
2009-05-27 00:00:00,425.886,1858.0,1191,517,870,52,70,51,83,61.0,18,67.0,32
2009-05-27 06:00:00,166.752,718.6,0,108,913,43,48,82,93,45.5,5,87.5,11
2009-05-27 12:00:00,505.224,2192.6,0,391,5535,46,59,59,93,52.5,13,76.0,34
2009-05-27 18:00:00,414.78,1813.2,0,1745,2603,61,61,52,55,61.0,0,53.5,3
2009-05-28 00:00:00,457.536,2005.4,1052,111,2025,50,59,59,71,54.5,9,65.0,12
2009-05-28 06:00:00,130.314,561.8,0,105,339,55,57,82,94,56.0,2,88.0,12
2009-05-28 12:00:00,486.46,2107.0,0,103,5941,55,59,82,94,57.0,4,88.0,12
2009-05-28 18:00:00,114.2,491.2,0,105,374,61,64,73,82,62.5,3,77.5,9
2009-05-29 00:00:00,448.762,1898.6,1502,108,2395,57,64,73,82,60.5,7,77.5,9
2009-05-29 06:00:00,126.14,541.2,0,108,419,54,57,88,100,55.5,3,94.0,12
2009-05-29 12:00:00,525.98,2180.6,0,106,6562,55,66,64,100,60.5,11,82.0,36
2009-05-29 18:00:00,226.516,968.0,0,109,1784,68,72,35,56,70.0,4,45.5,21
2009-05-30 00:00:00,364.21,1542.4,1005,111,1347,57,72,28,88,64.5,15,58.0,60
2009-05-30 06:00:00,200.994,853.6,0,110,1127,52,59,48,67,55.5,7,57.5,19
2009-05-30 12:00:00,367.284,1570.0,0,472,3105,55,70,38,59,62.5,15,48.5,21
2009-05-30 18:00:00,519.7280000000001,2205.8,935,761,4090,70,73,33,40,71.5,3,36.5,7
2009-05-31 00:00:00,571.1,2431.0,1852,364,3235,61,72,33,52,66.5,11,42.5,19
2009-05-31 06:00:00,184.962,819.6,466,114,1085,55,59,63,72,57.0,4,67.5,9
2009-05-31 12:00:00,245.882,1070.8,0,113,2178,57,68,59,67,62.5,11,63.0,8
2009-05-31 18:00:00,103.966,478.8,0,116,605,70,73,46,53,71.5,3,49.5,7
2009-06-01 00:00:00,422.08,1787.6,1000,115,1852,61,72,43,68,66.5,11,55.5,25
2009-06-01 06:00:00,96.894,445.6,0,114,479,55,61,82,88,58.0,6,85.0,6
2009-06-01 12:00:00,334.112,1430.8,216,113,2822,59,72,50,82,65.5,13,66.0,32
2009-06-01 18:00:00,599.772,2528.2,1718,117,5939,73,77,44,50,75.0,4,47.0,6
2009-06-02 00:00:00,412.482,1803.6,855,117,2121,63,77,41,72,70.0,14,56.5,31
2009-06-02 06:00:00,131.374,603.6,0,119,619,59,66,68,82,62.5,7,75.0,14
2009-06-02 12:00:00,432.548,1940.6,0,128,4412,59,70,40,72,64.5,11,56.0,32
2009-06-02 18:00:00,125.642,587.8,0,130,474,72,75,36,41,73.5,3,38.5,5
2009-06-03 00:00:00,401.074,1717.6,0,129,2387,64,73,31,73,68.5,9,52.0,42
2009-06-03 06:00:00,160.778,721.8,0,116,1091,54,61,72,88,57.5,7,80.0,16
2009-06-03 12:00:00,588.148,2488.8,940,778,5790,55,70,40,82,62.5,15,61.0,42
2009-06-03 18:00:00,329.034,1438.4,0,357,3055,70,73,41,49,71.5,3,45.0,8
2009-06-04 00:00:00,278.618,1221.4,0,119,1641,61,68,49,72,64.5,7,60.5,23
2009-06-04 06:00:00,96.496,430.0,0,116,478,52,57,63,71,54.5,5,67.0,8
2009-06-04 12:00:00,436.026,1841.8,997,110,4671,52,59,55,76,55.5,7,65.5,21
2009-06-04 18:00:00,96.794,435.2,0,113,468,61,66,40,48,63.5,5,44.0,8
2009-06-05 00:00:00,406.3440000000001,1733.2,909,116,1288,55,64,42,67,59.5,9,54.5,25
2009-06-05 06:00:00,174.31799999999998,755.0,0,116,1222,46,54,62,81,50.0,8,71.5,19
2009-06-05 12:00:00,483.884,2036.6,0,110,5973,48,59,45,76,53.5,11,60.5,31
2009-06-05 18:00:00,328.424,1412.4,0,113,3770,63,64,42,45,63.5,1,43.5,3
2009-06-06 00:00:00,243.734,1052.0,0,117,1550,55,64,42,58,59.5,9,50.0,16
2009-06-06 06:00:00,168.378,734.0,0,113,1233,54,55,62,63,54.5,1,62.5,1
2009-06-06 12:00:00,380.93,1620.0,0,106,3902,48,52,71,94,50.0,4,82.5,23
2009-06-06 18:00:00,333.794,1463.8,1024,106,1861,54,57,72,82,55.5,3,77.0,10
2009-06-07 00:00:00,592.348,2538.8,745,2407,3615,52,57,59,94,54.5,5,76.5,35
2009-06-07 06:00:00,141.298,628.6,0,163,464,54,54,88,100,54.0,0,94.0,12
2009-06-07 12:00:00,181.194,790.4,0,116,1060,54,59,55,94,56.5,5,74.5,39
2009-06-07 18:00:00,659.17,2825.6,2077,1242,3556,55,61,52,77,58.0,6,64.5,25
2009-06-08 00:00:00,225.73,981.0,0,120,954,54,55,77,88,54.5,1,82.5,11
2009-06-08 06:00:00,123.182,570.6,0,113,346,46,52,87,93,49.0,6,90.0,6
2009-06-08 12:00:00,378.958,1616.6,0,109,4209,48,59,63,93,53.5,11,78.0,30
2009-06-08 18:00:00,142.696,662.0,0,110,397,55,59,88,94,57.0,4,91.0,6
2009-06-09 00:00:00,533.94,2251.4,1024,100,3599,52,59,88,100,55.5,7,94.0,12
2009-06-09 06:00:00,148.772,653.6,0,88,1014,50,55,94,100,52.5,5,97.0,6
2009-06-09 12:00:00,522.0799999999999,2201.6,0,108,6172,52,61,77,100,56.5,9,88.5,23
2009-06-09 18:00:00,209.544,909.2,0,109,2031,57,64,68,94,60.5,7,81.0,26
2009-06-10 00:00:00,452.454,1934.8,1000,109,1478,54,64,73,100,59.0,10,86.5,27
2009-06-10 06:00:00,155.998,687.4,0,108,955,52,57,88,94,54.5,5,91.0,6
2009-06-10 12:00:00,382.408,1612.8,0,447,3851,52,57,82,94,54.5,5,88.0,12
2009-06-10 18:00:00,512.7420000000001,2202.6,0,4073,1907,57,61,82,94,59.0,4,88.0,12
2009-06-11 00:00:00,551.848,2314.0,1032,117,3176,57,64,82,94,60.5,7,88.0,12
2009-06-11 06:00:00,157.424,675.4,0,108,347,54,61,82,88,57.5,7,85.0,6
2009-06-11 12:00:00,537.468,2259.0,0,107,6008,52,63,59,88,57.5,11,73.5,29
2009-06-11 18:00:00,309.66400000000004,1334.8,0,109,2444,64,68,46,59,66.0,4,52.5,13
2009-06-12 00:00:00,296.094,1279.6,0,148,1811,55,66,46,88,60.5,11,67.0,42
2009-06-12 06:00:00,154.708,677.2,0,118,453,50,54,87,94,52.0,4,90.5,7
2009-06-12 12:00:00,415.596,1752.2,0,114,4200,54,68,59,94,61.0,14,76.5,35
2009-06-12 18:00:00,167.886,730.6,0,114,566,68,72,50,60,70.0,4,55.0,10
2009-06-13 00:00:00,363.542,1543.0,1009,114,1918,54,68,60,82,61.0,14,71.0,22
2009-06-13 06:00:00,14.218,60.2,0,5,79,54,61,77,94,57.5,7,85.5,17
2009-06-13 12:00:00,0.0,0.0,0,0,0,57,73,57,88,65.0,16,72.5,31
2009-06-13 18:00:00,0.0,0.0,0,0,0,75,77,44,50,76.0,2,47.0,6
2009-06-14 00:00:00,0.0,0.0,0,0,0,64,75,50,68,69.5,11,59.0,18
2009-06-14 06:00:00,0.0,0.0,0,0,0,61,66,73,82,63.5,5,77.5,9
2009-06-14 12:00:00,0.0,0.0,0,0,0,63,79,57,77,71.0,16,67.0,20
2009-06-14 18:00:00,0.0,0.0,0,0,0,77,82,45,65,79.5,5,55.0,20
2009-06-15 00:00:00,0.0,0.0,0,0,0,68,77,65,78,72.5,9,71.5,13
2009-06-15 06:00:00,0.0,0.0,0,0,0,61,68,83,94,64.5,7,88.5,11
2009-06-15 12:00:00,261.708,1117.2,916,87,2364,61,63,94,94,62.0,2,94.0,0
2009-06-15 18:00:00,129.96,590.8,0,137,570,61,64,77,94,62.5,3,85.5,17
2009-06-16 00:00:00,380.24,1624.6,0,124,2728,61,68,82,94,64.5,7,88.0,12
2009-06-16 06:00:00,99.554,498.8,0,121,415,52,57,88,100,54.5,5,94.0,12
2009-06-16 12:00:00,566.21,2383.2,934,122,6538,54,64,64,94,59.0,10,79.0,30
2009-06-16 18:00:00,338.944,1440.0,590,123,3650,66,72,46,60,69.0,6,53.0,14
2009-06-17 00:00:00,504.084,2136.2,1459,855,3088,59,72,41,88,65.5,13,64.5,47
2009-06-17 06:00:00,103.428,471.8,0,120,468,50,55,88,100,52.5,5,94.0,12
2009-06-17 12:00:00,343.904,1459.0,0,264,3895,54,72,50,94,63.0,18,72.0,44
2009-06-17 18:00:00,127.756,576.6,0,118,535,72,77,39,50,74.5,5,44.5,11
2009-06-18 00:00:00,412.928,1753.4,975,109,2295,57,75,47,82,66.0,18,64.5,35
2009-06-18 06:00:00,140.802,610.2,0,108,1094,55,63,68,88,59.0,8,78.0,20
2009-06-18 12:00:00,416.922,1752.8,0,112,5398,55,66,73,88,60.5,11,80.5,15
2009-06-18 18:00:00,131.516,572.6,0,119,1044,66,70,68,78,68.0,4,73.0,10
2009-06-19 00:00:00,476.46,1971.2,0,122,3687,64,70,68,83,67.0,6,75.5,15
2009-06-19 06:00:00,142.196,606.8,0,122,1126,57,61,67,72,59.0,4,69.5,5
2009-06-19 12:00:00,445.25,1878.4,969,117,4515,55,64,56,88,59.5,9,72.0,32
2009-06-19 18:00:00,170.5,760.4,0,119,1388,64,68,43,52,66.0,4,47.5,9
2009-06-20 00:00:00,328.92,1374.6,0,117,708,59,68,40,68,63.5,9,54.0,28
2009-06-20 06:00:00,194.484,816.4,0,113,1125,48,52,76,93,50.0,4,84.5,17
2009-06-20 12:00:00,481.544,2036.4,0,2312,3837,50,63,59,94,56.5,13,76.5,35
2009-06-20 18:00:00,279.614,1182.2,0,117,3333,59,63,52,67,61.0,4,59.5,15
2009-06-21 00:00:00,151.458,644.2,0,115,864,57,61,55,63,59.0,4,59.0,8
2009-06-21 06:00:00,136.234,579.0,0,112,629,46,55,72,93,50.5,9,82.5,21
2009-06-21 12:00:00,161.20999999999998,690.0,0,108,1248,50,64,64,94,57.0,14,79.0,30
2009-06-21 18:00:00,106.626,490.6,0,93,393,66,70,46,56,68.0,4,51.0,10
2009-06-22 00:00:00,451.072,1886.8,1039,99,3732,55,68,46,72,61.5,13,59.0,26
2009-06-22 06:00:00,133.026,575.8,0,112,1104,55,59,72,88,57.0,4,80.0,16
2009-06-22 12:00:00,398.27,1669.8,0,111,4934,55,64,49,77,59.5,9,63.0,28
2009-06-22 18:00:00,251.93,1070.2,0,113,2815,64,68,37,49,66.0,4,43.0,12
2009-06-23 00:00:00,310.872,1318.2,0,113,2295,59,66,43,72,62.5,7,57.5,29
2009-06-23 06:00:00,129.356,561.6,0,112,1051,48,55,67,87,51.5,7,77.0,20
2009-06-23 12:00:00,371.796,1579.6,0,110,4119,54,68,43,77,61.0,14,60.0,34
2009-06-23 18:00:00,131.406,571.8,0,115,1070,68,72,38,46,70.0,4,42.0,8
2009-06-24 00:00:00,406.656,1715.2,1010,924,1946,57,72,43,63,64.5,15,53.0,20
2009-06-24 06:00:00,96.918,435.4,0,116,476,57,63,63,77,60.0,6,70.0,14
2009-06-24 12:00:00,508.088,2131.8,0,552,6161,59,70,56,72,64.5,11,64.0,16
2009-06-24 18:00:00,368.41,1552.0,0,452,4174,72,77,38,53,74.5,5,45.5,15
2009-06-25 00:00:00,561.458,2384.0,3059,119,3464,63,77,36,63,70.0,14,49.5,27
2009-06-25 06:00:00,101.76,452.4,0,119,557,63,66,64,77,64.5,3,70.5,13
2009-06-25 12:00:00,281.27,1196.8,0,118,3055,64,75,57,73,69.5,11,65.0,16
2009-06-25 18:00:00,137.988,603.4,0,127,1010,75,79,51,57,77.0,4,54.0,6
2009-06-26 00:00:00,250.344,1079.4,0,131,1602,66,79,51,73,72.5,13,62.0,22
2009-06-26 06:00:00,105.244,473.2,0,131,577,64,68,83,94,66.0,4,88.5,11
2009-06-26 12:00:00,532.3580000000001,2236.6,1067,126,5943,66,72,68,83,69.0,6,75.5,15
2009-06-26 18:00:00,187.732,855.6,0,130,1418,72,77,57,73,74.5,5,65.0,16
2009-06-27 00:00:00,451.988,1965.6,759,151,2014,66,73,60,83,69.5,7,71.5,23
2009-06-27 06:00:00,293.946,1254.6,791,127,1537,55,63,88,94,59.0,8,91.0,6
2009-06-27 12:00:00,380.838,1614.4,0,1309,3117,55,73,50,100,64.0,18,75.0,50
2009-06-27 18:00:00,385.434,1665.0,1033,838,2446,75,81,39,44,78.0,6,41.5,5
2009-06-28 00:00:00,648.8340000000001,2706.6000000000004,839,158,6368,64,79,42,83,71.5,15,62.5,41
2009-06-28 06:00:00,114.162,527.0,0,146,562,59,64,73,88,61.5,5,80.5,15
2009-06-28 12:00:00,308.88,1346.1999999999998,0,542,2554,63,75,57,82,69.0,12,69.5,25
2009-06-28 18:00:00,193.408,868.4000000000001,0,130,1492,77,81,45,51,79.0,4,48.0,6
2009-06-29 00:00:00,442.944,1879.4,0,603,2134,68,81,45,69,74.5,13,57.0,24
2009-06-29 06:00:00,191.252,814.6,0,140,1129,61,68,78,94,64.5,7,86.0,16
2009-06-29 12:00:00,296.482,1279.8,933,132,1949,64,81,48,94,72.5,17,71.0,46
2009-06-29 18:00:00,174.332,772.0,0,146,1161,82,86,31,39,84.0,4,35.0,8
2009-06-30 00:00:00,348.068,1491.6,861,180,2223,70,84,39,73,77.0,14,56.0,34
2009-06-30 06:00:00,122.778,557.2,0,146,652,63,72,64,82,67.5,9,73.0,18
2009-06-30 12:00:00,541.906,2316.2,0,165,6117,66,82,51,78,74.0,16,64.5,27
2009-06-30 18:00:00,245.874,1154.0,582,561,686,84,86,35,48,85.0,2,41.5,13
2009-07-01 00:00:00,281.88800000000003,1217.4,0,162,1534,73,84,40,61,78.5,11,50.5,21
2009-07-01 06:00:00,165.454,743.2,0,149,1145,64,72,64,88,68.0,8,76.0,24
2009-07-01 12:00:00,412.182,1747.2,0,142,4295,68,81,51,83,74.5,13,67.0,32
2009-07-01 18:00:00,356.218,1527.0,966,144,2578,82,86,35,45,84.0,4,40.0,10
2009-07-02 00:00:00,284.488,1234.2,23,155,1729,75,86,35,65,80.5,11,50.0,30
2009-07-02 06:00:00,144.90800000000002,653.2,0,149,751,64,73,64,83,68.5,9,73.5,19
2009-07-02 12:00:00,424.444,1797.4,0,146,4402,68,84,51,78,76.0,16,64.5,27
2009-07-02 18:00:00,259.78,1125.2,0,151,1210,86,90,31,45,88.0,4,38.0,14
2009-07-03 00:00:00,413.446,1773.8,637,157,1669,75,88,38,65,81.5,13,51.5,27
2009-07-03 06:00:00,116.442,530.4,0,150,711,64,70,73,88,67.0,6,80.5,15
2009-07-03 12:00:00,307.424,1326.0,856,169,2548,66,77,57,88,71.5,11,72.5,31
2009-07-03 18:00:00,179.42000000000002,828.2,0,162,1348,77,81,32,54,79.0,4,43.0,22
2009-07-04 00:00:00,260.862,1110.0,0,161,2764,72,79,39,69,75.5,7,54.0,30
2009-07-04 06:00:00,146.078,658.6,0,150,1244,63,68,64,82,65.5,5,73.0,18
2009-07-04 12:00:00,275.416,1236.8,0,1504,1211,64,75,47,77,69.5,11,62.0,30
2009-07-04 18:00:00,421.322,1871.8,831,351,3059,77,82,35,44,79.5,5,39.5,9
2009-07-05 00:00:00,395.752,1768.4,1253,324,1277,70,82,37,60,76.0,12,48.5,23
2009-07-05 06:00:00,290.284,1302.6,533,266,1349,66,72,57,78,69.0,6,67.5,21
2009-07-05 12:00:00,302.764,1338.0,842,455,1580,66,75,53,83,70.5,9,68.0,30
2009-07-05 18:00:00,369.236,1636.6,0,537,2105,77,81,39,54,79.0,4,46.5,15
2009-07-06 00:00:00,448.452,1929.6,1840,180,2980,68,77,44,60,72.5,9,52.0,16
2009-07-06 06:00:00,114.83,546.8,0,182,666,59,64,72,88,61.5,5,80.0,16
2009-07-06 12:00:00,339.42,1446.4,0,185,3980,63,72,50,88,67.5,9,69.0,38
2009-07-06 18:00:00,109.574,508.4,0,188,585,68,73,47,60,70.5,5,53.5,13
2009-07-07 00:00:00,390.436,1677.0,429,200,1911,66,72,50,64,69.0,6,57.0,14
2009-07-07 06:00:00,133.766,615.4,430,167,581,59,61,77,82,60.0,2,79.5,5
2009-07-07 12:00:00,337.562,1517.2,0,188,3343,57,66,56,82,61.5,9,69.0,26
2009-07-07 18:00:00,125.728,583.8,0,188,564,66,72,43,60,69.0,6,51.5,17
2009-07-08 00:00:00,513.08,2185.0,862,3076,1216,59,66,60,94,62.5,7,77.0,34
2009-07-08 06:00:00,174.806,780.4,0,246,1178,57,57,88,88,57.0,0,88.0,0
2009-07-08 12:00:00,545.252,2300.6000000000004,0,1602,5405,57,64,73,94,60.5,7,83.5,21
2009-07-08 18:00:00,128.778,596.6,0,233,570,63,68,64,82,65.5,5,73.0,18
2009-07-09 00:00:00,385.564,1637.4,0,1433,2155,57,64,64,94,60.5,7,79.0,30
2009-07-09 06:00:00,116.006,534.8,0,198,466,54,55,82,88,54.5,1,85.0,6
2009-07-09 12:00:00,260.542,1207.4,0,191,1970,54,64,56,94,59.0,10,75.0,38
2009-07-09 18:00:00,158.966,705.8,0,133,1108,66,70,46,60,68.0,4,53.0,14
2009-07-10 00:00:00,310.738,1313.0,0,134,1239,59,66,46,67,62.5,7,56.5,21
2009-07-10 06:00:00,146.456,637.5999999999999,0,189,1132,50,59,63,88,54.5,9,75.5,25
2009-07-10 12:00:00,401.256,1680.4,988,125,4130,54,63,45,88,58.5,9,66.5,43
2009-07-10 18:00:00,218.826,957.4,0,135,1154,64,68,43,52,66.0,4,47.5,9
2009-07-11 00:00:00,420.58,1780.0,0,2175,1076,59,66,49,67,62.5,7,58.0,18
2009-07-11 06:00:00,153.95600000000002,678.4,0,259,1113,57,59,72,77,58.0,2,74.5,5
2009-07-11 12:00:00,271.478,1217.6,0,131,2011,59,66,60,72,62.5,7,66.0,12
2009-07-11 18:00:00,462.192,1956.4,981,176,4125,68,72,53,57,70.0,4,55.0,4
2009-07-12 00:00:00,106.342,493.8,0,117,507,61,72,53,73,66.5,11,63.0,20
2009-07-12 06:00:00,126.274,576.2,0,175,993,63,64,88,94,63.5,1,91.0,6
2009-07-12 12:00:00,134.164,594.0,0,117,1219,63,66,83,88,64.5,3,85.5,5
2009-07-12 18:00:00,107.19,498.4,0,176,465,66,81,42,88,73.5,15,65.0,46
2009-07-13 00:00:00,145.85,636.8,0,121,1383,64,77,50,83,70.5,13,66.5,33
2009-07-13 06:00:00,94.042,446.0,0,175,466,59,63,77,94,61.0,4,85.5,17
2009-07-13 12:00:00,149.526,656.8,0,117,1450,59,75,47,88,67.0,16,67.5,41
2009-07-13 18:00:00,94.142,444.8,0,176,469,72,77,47,60,74.5,5,53.5,13
2009-07-14 00:00:00,159.036,702.4,0,126,1496,66,70,68,83,68.0,4,75.5,15
2009-07-14 06:00:00,96.15,449.8,0,176,497,59,64,88,94,61.5,5,91.0,6
2009-07-14 12:00:00,230.512,1027.4,869,132,1477,61,73,46,88,67.0,12,67.0,42
2009-07-14 18:00:00,291.26,1321.2,1434,169,1312,75,79,34,44,77.0,4,39.0,10
2009-07-15 00:00:00,293.508,1255.6,0,141,2869,64,77,41,88,70.5,13,64.5,47
2009-07-15 06:00:00,103.8,462.2,0,159,476,57,64,64,82,60.5,7,73.0,18
2009-07-15 12:00:00,355.09,1486.8,878,150,3695,59,73,47,82,66.0,14,64.5,35
2009-07-15 18:00:00,107.656,478.2,0,143,531,73,79,34,41,76.0,6,37.5,7
2009-07-16 00:00:00,151.528,694.0,0,480,1118,66,77,34,64,71.5,11,49.0,30
2009-07-16 06:00:00,160.348,732.4,0,519,1249,57,61,68,88,59.0,4,78.0,20
2009-07-16 12:00:00,133.774,609.8,0,516,622,59,79,42,82,69.0,20,62.0,40
2009-07-16 18:00:00,193.004,846.6,0,518,1443,81,88,27,39,84.5,7,33.0,12
2009-07-17 00:00:00,112.428,512.8,0,171,588,64,88,31,73,76.0,24,52.0,42
2009-07-17 06:00:00,164.602,726.2,0,201,1520,63,64,83,94,63.5,1,88.5,11
2009-07-17 12:00:00,278.972,1170.0,0,119,3383,59,66,60,88,62.5,7,74.0,28
2009-07-17 18:00:00,142.27,630.8,0,181,544,64,68,52,83,66.0,4,67.5,31
2009-07-18 00:00:00,145.964,634.2,0,125,1223,57,68,56,94,62.5,11,75.0,38
2009-07-18 06:00:00,101.214,456.8,0,159,515,55,57,88,94,56.0,2,91.0,6
2009-07-18 12:00:00,183.71,789.6,0,147,1297,57,68,56,88,62.5,11,72.0,32
2009-07-18 18:00:00,213.568,931.6,0,126,1188,68,72,41,49,70.0,4,45.0,8
2009-07-19 00:00:00,467.918,1976.2,0,231,2389,57,68,49,94,62.5,11,71.5,45
2009-07-19 06:00:00,526.464,2211.8,0,181,1169,57,61,88,94,59.0,4,91.0,6
2009-07-19 12:00:00,255.5,1098.0,0,131,1713,57,64,68,94,60.5,7,81.0,26
2009-07-19 18:00:00,187.386,783.2,0,173,1088,66,72,46,52,69.0,6,49.0,6
2009-07-20 00:00:00,234.294,984.2,0,113,1088,59,70,46,94,64.5,11,70.0,48
2009-07-20 06:00:00,134.928,601.0,0,164,1170,55,64,64,88,59.5,9,76.0,24
2009-07-20 12:00:00,95.43,438.0,0,133,451,55,68,52,88,61.5,13,70.0,36
2009-07-20 18:00:00,317.4,1353.4,914,143,2827,70,77,36,53,73.5,7,44.5,17
2009-07-21 00:00:00,114.728,556.6,0,344,500,64,75,41,68,69.5,11,54.5,27
2009-07-21 06:00:00,158.138,726.8,0,376,1236,63,66,60,82,64.5,3,71.0,22
2009-07-21 12:00:00,380.994,1611.4,0,212,4853,64,82,48,77,73.0,18,62.5,29
2009-07-21 18:00:00,114.64600000000002,546.0,0,204,529,84,88,35,40,86.0,4,37.5,5
2009-07-22 00:00:00,159.984,716.6,0,189,1177,66,86,37,60,76.0,20,48.5,23
2009-07-22 06:00:00,111.124,518.6,0,177,603,64,73,61,88,68.5,9,74.5,27
2009-07-22 12:00:00,158.55599999999998,702.4,0,142,1335,64,73,65,83,68.5,9,74.0,18
2009-07-22 18:00:00,117.276,545.8,0,160,543,79,82,45,54,80.5,3,49.5,9
2009-07-23 00:00:00,352.576,1491.2,0,202,1484,64,79,57,94,71.5,15,75.5,37
2009-07-23 06:00:00,345.262,1455.2,926,140,1629,63,64,88,94,63.5,1,91.0,6
2009-07-23 12:00:00,353.588,1487.4,0,173,4491,64,70,78,94,67.0,6,86.0,16
2009-07-23 18:00:00,121.564,552.0,0,170,704,66,73,69,88,69.5,7,78.5,19
2009-07-24 00:00:00,209.586,901.4,0,139,2240,61,70,68,88,65.5,9,78.0,20
2009-07-24 06:00:00,164.76,729.4,0,180,1182,59,61,88,94,60.0,2,91.0,6
2009-07-24 12:00:00,158.392,713.2,0,135,1195,59,66,60,94,62.5,7,77.0,34
2009-07-24 18:00:00,99.608,469.8,0,166,523,64,72,46,73,68.0,8,59.5,27
2009-07-25 00:00:00,138.978,617.0,0,149,1228,59,66,56,82,62.5,7,69.0,26
2009-07-25 06:00:00,94.686,449.2,0,137,508,54,57,88,94,55.5,3,91.0,6
2009-07-25 12:00:00,181.818,798.6,0,163,1344,55,68,60,94,61.5,13,77.0,34
2009-07-25 18:00:00,101.496,463.4,0,109,452,70,73,41,56,71.5,3,48.5,15
2009-07-26 00:00:00,158.68800000000002,711.1999999999999,0,168,1412,59,73,44,82,66.0,14,63.0,38
2009-07-26 06:00:00,100.928,468.6,0,145,512,54,61,72,94,57.5,7,83.0,22
2009-07-26 12:00:00,154.024,680.4000000000001,0,125,1418,54,72,46,94,63.0,18,70.0,48
2009-07-26 18:00:00,162.684,721.2,0,222,1347,73,81,30,44,77.0,8,37.0,14
2009-07-27 00:00:00,125.38,602.8,0,527,522,63,79,32,68,71.0,16,50.0,36
2009-07-27 06:00:00,179.59799999999998,813.8,0,519,1453,57,63,77,94,60.0,6,85.5,17
2009-07-27 12:00:00,224.542,990.4,0,514,2073,57,72,57,94,64.5,15,75.5,37
2009-07-27 18:00:00,120.44,581.0,0,516,470,63,70,60,83,66.5,7,71.5,23
2009-07-28 00:00:00,163.986,757.0,0,513,1206,57,68,56,77,62.5,11,66.5,21
2009-07-28 06:00:00,119.23,578.2,0,512,462,54,55,88,94,54.5,1,91.0,6
2009-07-28 12:00:00,192.508,871.4,0,508,1291,54,72,57,94,63.0,18,75.5,37
2009-07-28 18:00:00,179.422,791.0,0,465,1224,72,77,32,57,74.5,5,44.5,25
2009-07-29 00:00:00,411.69,1745.4,0,3414,1376,55,77,29,82,66.0,22,55.5,53
2009-07-29 06:00:00,156.66,705.0,0,273,535,54,59,67,94,56.5,5,80.5,27
2009-07-29 12:00:00,332.034,1399.0,0,160,3805,54,73,53,94,63.5,19,73.5,41
2009-07-29 18:00:00,233.77,1012.2,443,135,1885,77,81,32,42,79.0,4,37.0,10
2009-07-30 00:00:00,179.536,788.2,426,181,1324,64,81,36,53,72.5,17,44.5,17
2009-07-30 06:00:00,98.938,450.0,0,115,528,55,66,64,88,60.5,11,76.0,24
2009-07-30 12:00:00,183.534,800.0,0,605,1348,55,68,56,88,61.5,13,72.0,32
2009-07-30 18:00:00,115.086,518.6,0,151,520,70,75,31,49,72.5,5,40.0,18
2009-07-31 00:00:00,394.768,1702.8,0,1433,1644,63,73,29,56,68.0,10,42.5,27
2009-07-31 06:00:00,208.284,933.8,0,194,1189,57,61,59,72,59.0,4,65.5,13
2009-07-31 12:00:00,138.954,630.6,0,149,955,57,70,46,72,63.5,13,59.0,26
2009-07-31 18:00:00,236.208,1042.4,0,1020,1606,72,77,29,43,74.5,5,36.0,14
2009-08-01 00:00:00,392.384,1716.4,865,2060,2552,61,77,25,59,69.0,16,42.0,34
2009-08-01 06:00:00,151.01,689.2,0,240,1262,61,66,52,68,63.5,5,60.0,16
2009-08-01 12:00:00,145.87599999999998,664.5999999999999,0,132,1132,61,75,47,72,68.0,14,59.5,25
2009-08-01 18:00:00,177.22,806.8000000000001,0,193,1426,77,81,30,41,79.0,4,35.5,11
2009-08-02 00:00:00,232.86,1018.0,0,279,2428,66,81,32,60,73.5,15,46.0,28
2009-08-02 06:00:00,104.522,490.2,0,195,544,61,66,88,100,63.5,5,94.0,12
2009-08-02 12:00:00,137.19,625.2,0,130,1139,59,63,77,94,61.0,4,85.5,17
2009-08-02 18:00:00,136.784,628.4,0,184,1126,66,70,49,73,68.0,4,61.0,24
2009-08-03 00:00:00,111.228,514.8,0,128,730,61,70,49,73,65.5,9,61.0,24
2009-08-03 06:00:00,151.936,668.4,0,169,1365,57,61,63,77,59.0,4,70.0,14
2009-08-03 12:00:00,96.45,444.8,0,132,516,59,70,43,67,64.5,11,55.0,24
2009-08-03 18:00:00,152.802,675.0,0,162,1406,70,75,36,43,72.5,5,39.5,7
2009-08-04 00:00:00,99.11,466.2000000000001,0,142,524,59,72,41,77,65.5,13,59.0,36
2009-08-04 06:00:00,153.092,677.0,0,155,1435,54,57,82,94,55.5,3,88.0,12
2009-08-04 12:00:00,102.414,481.2,0,136,509,54,75,47,94,64.5,21,70.5,47
2009-08-04 18:00:00,153.602,694.8,0,167,1410,77,81,34,42,79.0,4,38.0,8
2009-08-05 00:00:00,99.784,464.6,0,149,517,59,81,34,77,70.0,22,55.5,43
2009-08-05 06:00:00,157.30200000000002,695.4,0,150,1490,61,66,56,72,63.5,5,64.0,16
2009-08-05 12:00:00,100.404,478.0,0,147,528,63,79,44,72,71.0,16,58.0,28
2009-08-05 18:00:00,157.398,703.0,0,163,1487,79,86,25,42,82.5,7,33.5,17
2009-08-06 00:00:00,103.548,491.6,0,160,537,68,84,28,56,76.0,16,42.0,28
2009-08-06 06:00:00,159.464,708.8000000000001,0,154,1518,61,73,50,77,67.0,12,63.5,27
2009-08-06 12:00:00,103.122,486.6,0,166,538,59,82,39,82,70.5,23,60.5,43
2009-08-06 18:00:00,163.39,717.0,0,142,1576,84,90,24,33,87.0,6,28.5,9
2009-08-07 00:00:00,106.696,503.0,0,197,561,72,88,29,60,80.0,16,44.5,31
2009-08-07 06:00:00,161.73,718.6,0,132,1544,66,70,64,83,68.0,4,73.5,19
2009-08-07 12:00:00,109.52,511.2,0,195,601,66,70,73,83,68.0,4,78.0,10
2009-08-07 18:00:00,160.8,709.4,0,138,1530,70,75,57,73,72.5,5,65.0,16
2009-08-08 00:00:00,107.246,502.8,0,203,557,68,73,57,73,70.5,5,65.0,16
2009-08-08 06:00:00,146.644,648.2,0,128,1304,63,66,73,82,64.5,3,77.5,9
2009-08-08 12:00:00,117.226,540.4,0,192,754,63,68,73,83,65.5,5,78.0,10
2009-08-08 18:00:00,134.43200000000002,608.8,0,133,1115,72,75,57,64,73.5,3,60.5,7
2009-08-09 00:00:00,128.17,592.6,0,193,920,68,73,57,68,70.5,5,62.5,11
2009-08-09 06:00:00,131.172,590.4,0,129,1070,64,70,64,77,67.0,6,70.5,13
2009-08-09 12:00:00,135.65800000000002,618.4,0,193,1036,63,75,47,82,69.0,12,64.5,35
2009-08-09 18:00:00,220.078,970.2,119,498,1508,77,81,34,47,79.0,4,40.5,13
2009-08-10 00:00:00,511.326,2223.4,1865,1560,1540,70,79,39,64,74.5,9,51.5,25
2009-08-10 06:00:00,121.704,574.6,0,154,612,63,70,60,72,66.5,7,66.0,12
2009-08-10 12:00:00,228.026,1005.2,0,184,2281,63,79,39,72,71.0,16,55.5,33
2009-08-10 18:00:00,114.188,535.4,0,147,626,79,82,32,39,80.5,3,35.5,7
2009-08-11 00:00:00,605.4399999999999,2603.8,0,3234,2493,70,79,39,60,74.5,9,49.5,21
2009-08-11 06:00:00,120.234,580.0,0,296,566,64,70,64,88,67.0,6,76.0,24
2009-08-11 12:00:00,361.834,1548.2,857,150,3425,64,68,78,83,66.0,4,80.5,5
2009-08-11 18:00:00,125.278,604.0,0,188,613,68,77,50,78,72.5,9,64.0,28
2009-08-12 00:00:00,343.608,1514.0,0,833,1973,68,75,47,68,71.5,7,57.5,21
2009-08-12 06:00:00,145.352,658.8000000000001,0,159,1130,55,66,73,100,60.5,11,86.5,27
2009-08-12 12:00:00,174.662,794.0,0,186,1268,55,75,47,100,65.0,20,73.5,53
2009-08-12 18:00:00,140.844,636.6,0,130,957,79,86,35,42,82.5,7,38.5,7
2009-08-13 00:00:00,363.578,1588.8,912,214,1636,66,84,37,73,75.0,18,55.0,36
2009-08-13 06:00:00,96.158,447.2000000000001,0,141,521,64,68,78,88,66.0,4,83.0,10
2009-08-13 12:00:00,0.0,0.0,0,0,0,64,72,69,88,68.0,8,78.5,19
2009-08-13 18:00:00,0.0,0.0,0,0,0,72,77,50,69,74.5,5,59.5,19
2009-08-14 00:00:00,510.684,2178.2,1215,3561,1188,66,73,57,83,69.5,7,70.0,26
2009-08-14 06:00:00,193.302,860.2,429,314,1364,61,63,82,88,62.0,2,85.0,6
2009-08-14 12:00:00,197.556,866.2,0,185,1276,61,73,47,88,67.0,12,67.5,41
2009-08-14 18:00:00,151.458,670.4,0,168,606,75,81,32,44,78.0,6,38.0,12
2009-08-15 00:00:00,206.36,891.0,0,183,1401,66,81,32,78,73.5,15,55.0,46
2009-08-15 06:00:00,162.614,724.6,0,164,1440,59,66,56,72,62.5,7,64.0,16
2009-08-15 12:00:00,166.7,781.2,0,607,617,57,81,45,77,69.0,24,61.0,32
2009-08-15 18:00:00,568.454,2504.2,2438,458,3083,82,91,24,42,86.5,9,33.0,18
2009-08-16 00:00:00,616.294,2622.4,999,623,3782,68,91,26,56,79.5,23,41.0,30
2009-08-16 06:00:00,342.646,1514.2,760,206,1397,63,73,61,88,68.0,10,74.5,27
2009-08-16 12:00:00,226.782,1027.8,0,444,1576,61,75,57,94,68.0,14,75.5,37
2009-08-16 18:00:00,226.468,1092.6,0,238,959,81,90,31,48,85.5,9,39.5,17
2009-08-17 00:00:00,421.816,1829.4,844,206,1759,75,88,35,61,81.5,13,48.0,26
2009-08-17 06:00:00,122.398,571.8,1,202,732,63,72,69,82,67.5,9,75.5,13
2009-08-17 12:00:00,267.456,1156.4,0,202,2872,61,66,73,88,63.5,5,80.5,15
2009-08-17 18:00:00,134.126,625.8000000000001,0,205,639,72,81,34,64,76.5,9,49.0,30
2009-08-18 00:00:00,261.928,1126.6,0,204,2018,64,79,39,65,71.5,15,52.0,26
2009-08-18 06:00:00,132.824,593.4,0,210,636,54,63,68,88,58.5,9,78.0,20
2009-08-18 12:00:00,223.57,971.8,0,506,1805,55,73,50,88,64.0,18,69.0,38
2009-08-18 18:00:00,298.278,1282.8,876,516,1717,77,84,28,47,80.5,7,37.5,19
2009-08-19 00:00:00,425.926,1843.8,1430,208,2166,64,82,32,64,73.0,18,48.0,32
2009-08-19 06:00:00,123.18,559.0,0,189,675,59,68,60,88,63.5,9,74.0,28
2009-08-19 12:00:00,315.272,1354.2,0,213,2655,61,86,40,82,73.5,25,61.0,42
2009-08-19 18:00:00,276.514,1235.0,896,208,1456,90,97,25,38,93.5,7,31.5,13
2009-08-20 00:00:00,165.776,777.1999999999999,0,202,1258,72,95,28,53,83.5,23,40.5,25
2009-08-20 06:00:00,154.356,730.0,0,200,997,72,79,54,78,75.5,7,66.0,24
2009-08-20 12:00:00,284.82,1235.0,0,199,3188,72,86,42,78,79.0,14,60.0,36
2009-08-20 18:00:00,123.012,582.0,0,251,714,77,90,27,57,83.5,13,42.0,30
2009-08-21 00:00:00,213.534,942.6,0,233,1239,70,79,46,64,74.5,9,55.0,18
2009-08-21 06:00:00,165.28199999999998,723.8,0,207,1339,61,68,49,72,64.5,7,60.5,23
2009-08-21 12:00:00,296.738,1286.8,872,173,2497,63,70,46,63,66.5,7,54.5,17
2009-08-21 18:00:00,146.096,661.4000000000001,0,196,1028,73,79,26,41,76.0,6,33.5,15
2009-08-22 00:00:00,553.63,2372.8,2171,311,2663,68,73,29,46,70.5,5,37.5,17
2009-08-22 06:00:00,173.724,785.0,360,201,1199,59,64,56,67,61.5,5,61.5,11
2009-08-22 12:00:00,423.5,1811.0,381,1012,3658,59,73,33,67,66.0,14,50.0,34
2009-08-22 18:00:00,368.866,1663.2,1018,1446,1166,75,79,26,31,77.0,4,28.5,5
2009-08-23 00:00:00,582.648,2596.2,2785,544,2526,66,79,26,52,72.5,13,39.0,26
2009-08-23 06:00:00,136.64600000000002,692.1999999999999,0,193,646,57,66,49,67,61.5,9,58.0,18
2009-08-23 12:00:00,298.402,1309.4,0,209,2728,57,77,39,67,67.0,20,53.0,28
2009-08-23 18:00:00,211.44,949.8,0,213,1515,79,84,22,34,81.5,5,28.0,12
2009-08-24 00:00:00,420.22,1844.4,949,204,2105,66,82,25,49,74.0,16,37.0,24
2009-08-24 06:00:00,153.586,699.6,0,182,1248,57,64,52,72,60.5,7,62.0,20
2009-08-24 12:00:00,349.838,1489.4,0,176,3810,57,75,44,72,66.0,18,58.0,28
2009-08-24 18:00:00,167.086,768.2,0,180,645,68,84,33,83,76.0,16,58.0,50
2009-08-25 00:00:00,581.744,2474.2,2279,199,2544,66,68,43,100,67.0,2,71.5,57
2009-08-25 06:00:00,128.452,602.4,0,213,604,63,64,94,100,63.5,1,97.0,6
2009-08-25 12:00:00,252.922,1108.4,0,208,2165,61,68,73,100,64.5,7,86.5,27
2009-08-25 18:00:00,114.18,533.2,0,153,584,70,73,38,64,71.5,3,51.0,26
2009-08-26 00:00:00,448.056,1916.4,1140,181,2938,61,73,38,100,67.0,12,69.0,62
2009-08-26 06:00:00,116.452,545.6,0,201,588,55,61,72,88,58.0,6,80.0,16
2009-08-26 12:00:00,423.352,1778.8,887,147,4423,55,68,56,88,61.5,13,72.0,32
2009-08-26 18:00:00,114.51,544.8,0,200,579,73,79,36,47,76.0,6,41.5,11
2009-08-27 00:00:00,482.232,2074.0,1244,968,2270,57,79,34,82,68.0,22,58.0,48
2009-08-27 06:00:00,165.48399999999998,729.4,0,140,1112,59,64,68,82,61.5,5,75.0,14
2009-08-27 12:00:00,186.156,840.0,0,191,1358,61,70,77,82,65.5,9,79.5,5
2009-08-27 18:00:00,137.97,641.2,0,169,961,70,79,47,88,74.5,9,67.5,41
2009-08-28 00:00:00,259.856,1126.8,0,164,852,66,79,44,73,72.5,13,58.5,29
2009-08-28 06:00:00,183.7,808.8,0,218,1295,63,64,68,77,63.5,1,72.5,9
2009-08-28 12:00:00,335.04200000000003,1449.8,1078,147,2807,61,68,46,82,64.5,7,64.0,36
2009-08-28 18:00:00,281.576,1218.2,650,446,2124,70,73,31,40,71.5,3,35.5,9
2009-08-29 00:00:00,318.524,1379.2,50,314,1259,61,70,35,73,65.5,9,54.0,38
2009-08-29 06:00:00,116.612,545.0,0,149,581,52,59,63,88,55.5,7,75.5,25
2009-08-29 12:00:00,273.026,1206.8,0,537,2253,50,66,52,94,58.0,16,73.0,42
2009-08-29 18:00:00,579.616,2487.4,905,583,5033,68,75,29,43,71.5,7,36.0,14
2009-08-30 00:00:00,419.16,1785.0,0,214,3840,59,72,33,59,65.5,13,46.0,26
2009-08-30 06:00:00,168.8,755.8,0,147,1014,48,59,63,93,53.5,11,78.0,30
2009-08-30 12:00:00,298.94,1304.6,0,171,2323,46,68,46,100,57.0,22,73.0,54
2009-08-30 18:00:00,708.612,3037.6,1823,876,5258,70,75,31,43,72.5,5,37.0,12
2009-08-31 00:00:00,491.99,2073.6,830,169,2053,59,73,31,59,66.0,14,45.0,28
2009-08-31 06:00:00,163.79,733.4,0,177,1108,54,61,59,82,57.5,7,70.5,23
2009-08-31 12:00:00,454.522,1946.4,0,140,5404,54,75,34,82,64.5,21,58.0,48
2009-08-31 18:00:00,248.606,1099.8,0,202,2141,79,86,20,28,82.5,7,24.0,8
2009-09-01 00:00:00,398.604,1724.6,960,159,1321,66,84,20,49,75.0,18,34.5,29
2009-09-01 06:00:00,134.712,647.4,0,161,594,70,72,50,53,71.0,2,51.5,3
2009-09-01 12:00:00,299.486,1293.4,0,215,2803,64,68,64,94,66.0,4,79.0,30
2009-09-01 18:00:00,148.25,670.6,0,144,806,63,68,73,94,65.5,5,83.5,21
2009-09-02 00:00:00,398.088,1700.0,0,177,1870,63,72,43,82,67.5,9,62.5,39
2009-09-02 06:00:00,166.016,727.2,0,178,1208,54,59,72,88,56.5,5,80.0,16
2009-09-02 12:00:00,568.14,2375.4,947,138,6194,54,63,77,88,58.5,9,82.5,11
2009-09-02 18:00:00,169.304,762.8,0,199,985,66,70,53,64,68.0,4,58.5,11
2009-09-03 00:00:00,319.354,1373.6,0,144,1534,61,68,56,73,64.5,7,64.5,17
2009-09-03 06:00:00,130.624,604.2,0,182,559,61,63,88,94,62.0,2,91.0,6
2009-09-03 12:00:00,413.99,1782.2,2370,358,1877,59,64,59,88,61.5,5,73.5,29
2009-09-03 18:00:00,338.832,1467.1999999999998,0,2420,1150,61,68,46,72,64.5,7,59.0,26
2009-09-04 00:00:00,367.742,1563.8,949,139,1425,55,64,52,94,59.5,9,73.0,42
2009-09-04 06:00:00,118.174,535.4,0,175,489,55,57,82,94,56.0,2,88.0,12
2009-09-04 12:00:00,477.752,1998.4,0,155,5564,55,59,88,100,57.0,4,94.0,12
2009-09-04 18:00:00,141.488,634.2,0,139,524,55,64,59,94,59.5,9,76.5,35
2009-09-05 00:00:00,286.974,1233.0,0,167,1518,55,63,52,94,59.0,8,73.0,42
2009-09-05 06:00:00,155.304,678.6,0,134,1174,50,54,77,87,52.0,4,82.0,10
2009-09-05 12:00:00,503.198,2146.6,1593,149,4389,50,64,56,94,57.0,14,75.0,38
2009-09-05 18:00:00,551.412,2376.6,1395,1789,3316,59,66,52,77,62.5,7,64.5,25
2009-09-06 00:00:00,303.952,1322.6,0,176,1554,54,64,56,82,59.0,10,69.0,26
2009-09-06 06:00:00,154.208,691.4,0,164,949,46,52,87,100,49.0,6,93.5,13
2009-09-06 12:00:00,304.92,1320.8,0,113,2504,46,64,59,100,55.0,18,79.5,41
2009-09-06 18:00:00,282.716,1207.4,995,155,1994,68,72,46,52,70.0,4,49.0,6
2009-09-07 00:00:00,486.786,2058.2,0,156,3584,54,70,49,82,62.0,16,65.5,33
2009-09-07 06:00:00,95.202,437.0,0,122,501,50,57,82,94,53.5,7,88.0,12
2009-09-07 12:00:00,442.766,1854.0,0,163,5162,50,68,60,100,59.0,18,80.0,40
2009-09-07 18:00:00,93.252,423.8,0,113,465,70,79,39,56,74.5,9,47.5,17
2009-09-08 00:00:00,590.2379999999999,2526.2,2196,179,2171,59,79,39,82,69.0,20,60.5,43
2009-09-08 06:00:00,107.014,485.8,0,129,656,54,57,88,100,55.5,3,94.0,12
2009-09-08 12:00:00,481.038,2001.4,0,149,5778,54,73,57,100,63.5,19,78.5,43
2009-09-08 18:00:00,106.766,484.6,0,161,474,79,84,33,44,81.5,5,38.5,11
2009-09-09 00:00:00,391.436,1671.2,1002,138,1625,57,82,35,94,69.5,25,64.5,59
2009-09-09 06:00:00,111.808,506.4,0,177,523,55,61,77,94,58.0,6,85.5,17
2009-09-09 12:00:00,496.216,2070.2,0,350,6064,59,72,57,88,65.5,13,72.5,31
2009-09-09 18:00:00,366.446,1582.2,0,3145,1056,72,75,53,69,73.5,3,61.0,16
2009-09-10 00:00:00,546.874,2308.6,964,160,3028,64,70,64,88,67.0,6,76.0,24
2009-09-10 06:00:00,100.926,464.4,0,168,500,61,63,82,88,62.0,2,85.0,6
2009-09-10 12:00:00,390.5,1652.1999999999998,0,133,4141,59,61,82,88,60.0,2,85.0,6
2009-09-10 18:00:00,100.588,461.6,0,178,481,64,72,56,77,68.0,8,66.5,21
2009-09-11 00:00:00,520.34,2187.0,928,121,1386,63,70,49,88,66.5,7,68.5,39
2009-09-11 06:00:00,144.012,638.6,0,167,1199,55,61,72,77,58.0,6,74.5,5
2009-09-11 12:00:00,493.184,2050.2,0,168,6159,55,61,68,82,58.0,6,75.0,14
2009-09-11 18:00:00,218.964,930.0,0,120,2521,64,70,46,59,67.0,6,52.5,13
2009-09-12 00:00:00,357.98600000000005,1515.6,0,176,1814,61,66,49,68,63.5,5,58.5,19
2009-09-12 06:00:00,139.008,616.8,0,135,1190,55,59,67,82,57.0,4,74.5,15
2009-09-12 12:00:00,461.876,1967.0,963,151,4467,54,64,59,88,59.0,10,73.5,29
2009-09-12 18:00:00,410.646,1806.4,2331,789,1621,66,70,43,56,68.0,4,49.5,13
2009-09-13 00:00:00,1052.828,4455.0,6289,127,5323,59,68,43,63,63.5,9,53.0,20
2009-09-13 06:00:00,107.186,510.2,12,176,538,54,57,72,88,55.5,3,80.0,16
2009-09-13 12:00:00,260.568,1133.4,926,122,1438,54,64,59,94,59.0,10,76.5,35
2009-09-13 18:00:00,471.928,2030.2,2354,167,2830,64,66,56,64,65.0,2,60.0,8
2009-09-14 00:00:00,730.62,3072.4,854,147,5364,59,64,56,67,61.5,5,61.5,11
2009-09-14 06:00:00,138.664,629.8,0,142,725,55,59,77,88,57.0,4,82.5,11
2009-09-14 12:00:00,685.466,2882.6,980,168,6151,54,61,72,88,57.5,7,80.0,16
2009-09-14 18:00:00,225.208,966.4,15,118,486,63,66,52,63,64.5,3,57.5,11
2009-09-15 00:00:00,525.52,2228.0,1848,175,1729,55,64,56,94,59.5,9,75.0,38
2009-09-15 06:00:00,142.292,628.2,0,114,989,54,55,88,94,54.5,1,91.0,6
2009-09-15 12:00:00,459.894,1929.6,0,169,5159,54,59,67,94,56.5,5,80.5,27
2009-09-15 18:00:00,119.11,538.2,0,117,464,59,64,56,63,61.5,5,59.5,7
2009-09-16 00:00:00,735.51,3074.4,1769,160,2032,54,61,63,88,57.5,7,75.5,25
2009-09-16 06:00:00,160.122,709.5999999999999,0,133,1171,54,55,77,94,54.5,1,85.5,17
2009-09-16 12:00:00,584.998,2456.0,0,531,5947,57,61,77,88,59.0,4,82.5,11
2009-09-16 18:00:00,362.584,1560.0,0,2634,1544,63,68,64,72,65.5,5,68.0,8
2009-09-17 00:00:00,635.458,2690.0,1035,172,4722,54,64,73,82,59.0,10,77.5,9
2009-09-17 06:00:00,116.086,527.8,0,115,481,61,63,77,82,62.0,2,79.5,5
2009-09-17 12:00:00,502.348,2104.6,0,166,5201,57,61,77,88,59.0,4,82.5,11
2009-09-17 18:00:00,248.794,1060.0,0,114,2743,61,64,68,77,62.5,3,72.5,9
2009-09-18 00:00:00,356.198,1507.2,0,168,1285,63,64,72,82,63.5,1,77.0,10
2009-09-18 06:00:00,106.558,479.0,0,124,416,61,61,82,82,61.0,0,82.0,0
2009-09-18 12:00:00,547.474,2300.4,1034,149,5266,59,68,73,88,63.5,9,80.5,15
2009-09-18 18:00:00,161.2,695.6,0,145,1470,70,75,53,64,72.5,5,58.5,11
2009-09-19 00:00:00,558.8,2340.6,959,234,1999,63,73,57,83,68.0,10,70.0,26
2009-09-19 06:00:00,146.874,639.2,0,189,1105,61,64,83,88,62.5,3,85.5,5
2009-09-19 12:00:00,422.342,1790.2,0,400,3979,59,66,68,94,62.5,7,81.0,26
2009-09-19 18:00:00,782.768,3299.0,967,2742,6863,72,75,47,53,73.5,3,50.0,6
2009-09-20 00:00:00,783.726,3285.2,640,719,2898,63,73,50,83,68.0,10,66.5,33
2009-09-20 06:00:00,402.228,1730.6,922,165,1467,57,61,82,88,59.0,4,85.0,6
2009-09-20 12:00:00,230.152,1026.4,0,130,1910,57,64,83,94,60.5,7,88.5,11
2009-09-20 18:00:00,702.4300000000001,2985.0,2333,1987,4722,68,73,57,78,70.5,5,67.5,21
2009-09-21 00:00:00,700.518,2932.6,1277,184,3836,63,73,57,88,68.0,10,72.5,31
2009-09-21 06:00:00,156.84,692.2,0,128,1125,59,63,82,88,61.0,4,85.0,6
2009-09-21 12:00:00,543.51,2279.4,0,169,6187,57,66,73,94,61.5,9,83.5,21
2009-09-21 18:00:00,224.54,987.4,0,143,1824,68,72,57,68,70.0,4,62.5,11
2009-09-22 00:00:00,492.978,2090.8,921,164,1708,59,70,60,88,64.5,11,74.0,28
2009-09-22 06:00:00,159.098,700.6,0,150,1199,52,55,88,100,53.5,3,94.0,12
2009-09-22 12:00:00,443.586,1871.4,0,140,4969,52,70,60,100,61.0,18,80.0,40
2009-09-22 18:00:00,204.842,895.2,0,168,783,72,75,41,57,73.5,3,49.0,16
2009-09-23 00:00:00,439.01,1859.6,937,139,1551,57,72,46,88,64.5,15,67.0,42
2009-09-23 06:00:00,103.62,475.4,0,172,505,48,59,77,94,53.5,11,85.5,17
2009-09-23 12:00:00,611.2,2567.4,486,500,6340,48,63,72,100,55.5,15,86.0,28
2009-09-23 18:00:00,373.372,1589.0,0,173,3815,64,72,46,73,68.0,8,59.5,27
2009-09-24 00:00:00,548.418,2315.8,1599,133,2224,55,70,43,82,62.5,15,62.5,39
2009-09-24 06:00:00,97.29,462.0,0,161,487,52,57,88,100,54.5,5,94.0,12
2009-09-24 12:00:00,537.098,2252.8,0,151,5497,55,61,88,94,58.0,6,91.0,6
2009-09-24 18:00:00,109.22,503.0,0,138,478,63,68,68,82,65.5,5,75.0,14
2009-09-25 00:00:00,682.65,2880.6,1051,171,3912,57,66,73,94,61.5,9,83.5,21
2009-09-25 06:00:00,103.342,469.0,0,114,482,50,57,77,87,53.5,7,82.0,10
2009-09-25 12:00:00,447.568,1880.0,0,167,5245,50,63,63,87,56.5,13,75.0,24
2009-09-25 18:00:00,268.83,1213.0,0,128,2464,66,70,38,56,68.0,4,47.0,18
2009-09-26 00:00:00,341.276,1454.4,0,185,1503,57,66,43,82,61.5,9,62.5,39
2009-09-26 06:00:00,147.698,644.6,0,130,762,50,54,72,82,52.0,4,77.0,10
2009-09-26 12:00:00,569.41,2385.4,1042,147,6022,48,63,59,93,55.5,15,76.0,34
2009-09-26 18:00:00,553.832,2362.4,901,159,5073,66,70,40,49,68.0,4,44.5,9
2009-09-27 00:00:00,285.314,1210.4,0,135,2724,57,68,43,67,62.5,11,55.0,24
2009-09-27 06:00:00,125.602,567.8,0,166,866,52,54,77,82,53.0,2,79.5,5
2009-09-27 12:00:00,250.578,1077.8,0,877,1661,50,64,56,87,57.0,14,71.5,31
2009-09-27 18:00:00,424.362,1848.8,932,2148,2065,68,73,38,52,70.5,5,45.0,14
2009-09-28 00:00:00,609.93,2554.4,885,1380,3962,57,70,43,67,63.5,13,55.0,24
2009-09-28 06:00:00,113.05,513.2,0,179,670,50,57,72,87,53.5,7,79.5,15
2009-09-28 12:00:00,515.124,2134.8,0,118,6142,48,66,60,94,57.0,18,77.0,34
2009-09-28 18:00:00,125.538,549.0,0,174,843,68,72,41,60,70.0,4,50.5,19
2009-09-29 00:00:00,545.744,2268.4,0,132,3142,57,68,49,77,62.5,11,63.0,28
2009-09-29 06:00:00,96.384,433.8,0,163,480,52,57,88,100,54.5,5,94.0,12
2009-09-29 12:00:00,444.154,1866.8,0,139,4561,57,64,59,82,60.5,7,70.5,23
2009-09-29 18:00:00,172.294,752.8,0,153,474,66,72,46,56,69.0,6,51.0,10
2009-09-30 00:00:00,433.566,1833.8,1031,148,1807,55,68,56,88,61.5,13,72.0,32
2009-09-30 06:00:00,132.286,575.0,0,150,1109,52,55,88,94,53.5,3,91.0,6
2009-09-30 12:00:00,446.388,1857.6,0,389,5045,55,61,77,94,58.0,6,85.5,17
2009-09-30 18:00:00,454.374,1977.4,0,5639,483,61,70,56,77,65.5,9,66.5,21
2009-10-01 00:00:00,739.688,3114.4,970,1902,2559,59,66,64,82,62.5,7,73.0,18
2009-10-01 06:00:00,96.566,434.6,0,194,482,50,57,72,94,53.5,7,83.0,22
2009-10-01 12:00:00,429.98,1800.2,0,120,4195,57,64,68,88,60.5,7,78.0,20
2009-10-01 18:00:00,94.076,424.6,0,170,463,66,68,46,60,67.0,2,53.0,14
2009-10-02 00:00:00,666.63,2793.4,950,118,4293,57,64,56,82,60.5,7,69.0,26
2009-10-02 06:00:00,96.142,428.6,0,173,473,45,52,82,100,48.5,7,91.0,18
2009-10-02 12:00:00,521.664,2168.0,0,110,6228,43,59,72,100,51.0,16,86.0,28
2009-10-02 18:00:00,235.896,1000.6,0,166,2322,61,64,49,63,62.5,3,56.0,14
2009-10-03 00:00:00,298.966,1278.8,0,121,1119,48,59,55,82,53.5,11,68.5,27
2009-10-03 06:00:00,137.076,603.8,0,151,1025,43,45,87,93,44.0,2,90.0,6
2009-10-03 12:00:00,416.644,1769.2,1053,130,3763,41,57,63,93,49.0,16,78.0,30
2009-10-03 18:00:00,706.8119999999999,2985.6,2078,479,5423,61,64,45,55,62.5,3,50.0,10
2009-10-04 00:00:00,456.208,1914.0,513,160,4269,46,61,48,87,53.5,15,67.5,39
2009-10-04 06:00:00,118.96,524.2,0,112,409,55,57,63,72,56.0,2,67.5,9
2009-10-04 12:00:00,270.312,1188.2,0,1772,1093,55,61,67,72,58.0,6,69.5,5
2009-10-04 18:00:00,578.4300000000001,2468.0,2278,1434,3127,63,64,52,59,63.5,1,55.5,7
2009-10-05 00:00:00,653.404,2753.4,911,181,4351,57,63,55,67,60.0,6,61.0,12
2009-10-05 06:00:00,126.02,523.6,0,111,455,57,59,63,67,58.0,2,65.0,4
2009-10-05 12:00:00,500.132,2086.8,0,159,5668,54,57,67,94,55.5,3,80.5,27
2009-10-05 18:00:00,128.264,533.8,0,108,461,55,68,83,100,61.5,13,91.5,17
2009-10-06 00:00:00,521.106,2181.8,984,164,1399,59,68,63,88,63.5,9,75.5,25
2009-10-06 06:00:00,175.754,738.2,1,118,1225,59,63,82,94,61.0,4,88.0,12
2009-10-06 12:00:00,608.482,2549.2,0,152,5389,61,63,94,100,62.0,2,97.0,6
2009-10-06 18:00:00,191.414,815.4,0,145,1088,64,73,69,94,68.5,9,81.5,25
2009-10-07 00:00:00,452.798,1903.4,0,128,1104,64,70,78,94,67.0,6,86.0,16
2009-10-07 06:00:00,181.72,771.5999999999999,0,165,1135,61,63,94,100,62.0,2,97.0,6
2009-10-07 12:00:00,596.456,2487.2,0,102,6276,59,68,78,100,63.5,9,89.0,22
2009-10-07 18:00:00,337.178,1454.6,0,2590,549,72,77,54,73,74.5,5,63.5,19
2009-10-08 00:00:00,706.48,2974.8,734,1477,1948,64,75,61,94,69.5,11,77.5,33
2009-10-08 06:00:00,170.808,719.1999999999999,0,168,1162,61,63,94,100,62.0,2,97.0,6
2009-10-08 12:00:00,611.1419999999999,2548.0,0,163,5987,61,66,83,100,63.5,5,91.5,17
2009-10-08 18:00:00,291.052,1214.6,0,141,3058,68,72,64,78,70.0,4,71.0,14
2009-10-09 00:00:00,504.164,2119.0,2091,147,1361,61,64,83,94,62.5,3,88.5,11
2009-10-09 06:00:00,128.302,552.0,0,161,480,57,59,88,94,58.0,2,91.0,6
2009-10-09 12:00:00,500.924,2092.6,0,109,5062,55,59,88,94,57.0,4,91.0,6
2009-10-09 18:00:00,403.11,1717.4,0,160,4133,61,64,83,94,62.5,3,88.5,11
2009-10-10 00:00:00,319.526,1331.2,0,129,1043,59,63,94,94,61.0,4,94.0,0
2009-10-10 06:00:00,167.196,717.8,0,141,1091,59,61,94,100,60.0,2,97.0,6
2009-10-10 12:00:00,447.628,1880.8,0,160,4092,57,63,82,100,60.0,6,91.0,18
2009-10-10 18:00:00,664.59,2840.8,3118,112,5247,66,68,52,68,67.0,2,60.0,16
2009-10-11 00:00:00,733.342,3095.8,1392,157,4381,54,61,68,94,57.5,7,81.0,26
2009-10-11 06:00:00,136.398,602.6,0,125,413,48,52,94,100,50.0,4,97.0,6
2009-10-11 12:00:00,621.31,2629.0,939,2672,3778,50,59,88,100,54.5,9,94.0,12
2009-10-11 18:00:00,637.7479999999999,2729.2,2546,2435,2840,59,63,63,82,61.0,4,72.5,19
2009-10-12 00:00:00,542.828,2309.0,626,1222,1617,52,61,72,94,56.5,9,83.0,22
2009-10-12 06:00:00,129.956,589.4,0,129,428,52,59,77,88,55.5,7,82.5,11
2009-10-12 12:00:00,591.846,2486.4,997,132,5802,50,57,72,87,53.5,7,79.5,15
2009-10-12 18:00:00,177.898,743.6,0,151,1369,59,61,59,67,60.0,2,63.0,8
2009-10-13 00:00:00,451.904,1895.4,0,103,1821,55,59,67,94,57.0,4,80.5,27
2009-10-13 06:00:00,159.888,669.6,0,143,1075,43,50,87,93,46.5,7,90.0,6
2009-10-13 12:00:00,608.846,2585.6,983,143,5332,43,57,67,100,50.0,14,83.5,33
2009-10-13 18:00:00,231.944,972.8,0,98,1451,57,59,55,63,58.0,2,59.0,8
2009-10-14 00:00:00,448.422,1891.6,0,146,1672,52,57,67,82,54.5,5,74.5,15
2009-10-14 06:00:00,156.364,657.6,0,142,1023,52,54,76,77,53.0,2,76.5,1
2009-10-14 12:00:00,686.264,2885.0,991,278,5972,48,52,58,87,50.0,4,72.5,29
2009-10-14 18:00:00,332.118,1414.2,0,2581,732,52,54,35,51,53.0,2,43.0,16
2009-10-15 00:00:00,536.478,2249.8,1010,130,2286,43,54,46,77,48.5,11,61.5,31
2009-10-15 06:00:00,158.706,669.4000000000001,0,107,1012,34,37,81,81,35.5,3,81.0,0
2009-10-15 12:00:00,525.184,2181.6,0,133,5234,34,46,53,87,40.0,12,70.0,34
2009-10-15 18:00:00,210.466,868.6,0,110,1922,48,52,47,54,50.0,4,50.5,7
2009-10-16 00:00:00,595.62,2507.4,1629,113,1473,41,50,54,76,45.5,9,65.0,22
2009-10-16 06:00:00,151.572,637.2,0,135,818,36,39,87,93,37.5,3,90.0,6
2009-10-16 12:00:00,610.954,2540.0,0,87,5461,36,52,67,100,44.0,16,83.5,33
2009-10-16 18:00:00,363.354,1535.4,0,134,3341,52,57,55,82,54.5,5,68.5,27
2009-10-17 00:00:00,390.98,1645.2,0,126,1516,41,55,62,81,48.0,14,71.5,19
2009-10-17 06:00:00,147.924,612.2,0,99,893,48,50,76,82,49.0,2,79.0,6
2009-10-17 12:00:00,652.79,2741.2,1046,132,5802,46,52,76,82,49.0,6,79.0,6
2009-10-17 18:00:00,948.244,4055.2,3157,3812,5039,50,55,58,82,52.5,5,70.0,24
2009-10-18 00:00:00,993.122,4177.0,1287,321,6592,45,52,71,87,48.5,7,79.0,16
2009-10-18 06:00:00,314.412,1302.8,0,135,3185,37,43,87,100,40.0,6,93.5,13
2009-10-18 12:00:00,297.132,1239.6,0,114,2808,37,50,71,100,43.5,13,85.5,29
2009-10-18 18:00:00,264.468,1094.6,0,137,2420,52,54,50,58,53.0,2,54.0,8
2009-10-19 00:00:00,680.152,2843.8,712,113,2731,43,48,62,87,45.5,5,74.5,25
2009-10-19 06:00:00,123.258,514.0,0,106,340,32,36,87,100,34.0,4,93.5,13
2009-10-19 12:00:00,533.274,2220.0,1104,128,4244,32,45,76,100,38.5,13,88.0,24
2009-10-19 18:00:00,121.698,501.2,0,89,340,48,52,41,62,50.0,4,51.5,21
2009-10-20 00:00:00,590.8779999999999,2457.2,0,134,3303,39,48,54,81,43.5,9,67.5,27
2009-10-20 06:00:00,133.57999999999998,558.6,0,89,516,37,39,75,87,38.0,2,81.0,12
2009-10-20 12:00:00,609.638,2526.4,0,133,5664,36,52,67,93,44.0,16,80.0,26
2009-10-20 18:00:00,358.096,1474.4,0,93,2388,55,61,55,67,58.0,6,61.0,12
2009-10-21 00:00:00,621.494,2604.6,760,135,2437,41,59,63,72,50.0,18,67.5,9
2009-10-21 06:00:00,119.102,510.4,0,101,377,54,59,59,82,56.5,5,70.5,23
2009-10-21 12:00:00,586.028,2433.8,1001,408,4420,54,55,77,88,54.5,1,82.5,11
2009-10-21 18:00:00,640.512,2699.0,0,4983,1631,54,54,94,94,54.0,0,94.0,0
2009-10-22 00:00:00,623.864,2584.0,1030,424,2141,52,52,94,94,52.0,0,94.0,0
2009-10-22 06:00:00,123.77,526.0,0,107,420,50,50,100,100,50.0,0,100.0,0
2009-10-22 12:00:00,594.266,2454.4,0,141,6211,50,54,82,94,52.0,4,88.0,12
2009-10-22 18:00:00,301.94,1252.2,0,102,3200,57,59,63,72,58.0,2,67.5,9
2009-10-23 00:00:00,379.734,1588.4,0,142,1243,52,55,77,94,53.5,3,85.5,17
2009-10-23 06:00:00,140.446,595.8,0,105,710,50,52,94,94,51.0,2,94.0,0
2009-10-23 12:00:00,429.08,1788.6,0,131,4031,50,54,88,100,52.0,4,94.0,12
2009-10-23 18:00:00,594.446,2552.0,3180,137,2790,55,57,77,88,56.0,2,82.5,11
2009-10-24 00:00:00,593.478,2472.2,0,122,4165,52,54,88,94,53.0,2,91.0,6
2009-10-24 06:00:00,155.094,652.8,0,145,891,52,54,88,100,53.0,2,94.0,12
2009-10-24 12:00:00,715.5740000000001,3000.0,1761,95,5262,55,59,94,100,57.0,4,97.0,6
2009-10-24 18:00:00,603.1700000000001,2575.6,2958,165,3440,61,64,88,100,62.5,3,94.0,12
2009-10-25 00:00:00,1140.57,4799.8,1483,113,6348,52,64,82,100,58.0,12,91.0,18
2009-10-25 06:00:00,406.232,1698.8,987,138,1244,50,55,88,100,52.5,5,94.0,12
2009-10-25 12:00:00,465.846,1986.0,0,2286,3225,50,54,94,100,52.0,4,97.0,6
2009-10-25 18:00:00,771.266,3266.8,1514,3621,4262,55,61,63,88,58.0,6,75.5,25
2009-10-26 00:00:00,787.2379999999999,3332.2,509,148,5051,48,57,77,93,52.5,9,85.0,16
2009-10-26 06:00:00,130.232,564.6,0,128,395,45,48,87,93,46.5,3,90.0,6
2009-10-26 12:00:00,349.22,1450.6,0,106,3341,45,59,77,100,52.0,14,88.5,23
2009-10-26 18:00:00,157.4,661.4,0,143,928,59,63,55,68,61.0,4,61.5,13
2009-10-27 00:00:00,475.492,1987.8,475,91,1124,43,52,82,100,47.5,9,91.0,18
2009-10-27 06:00:00,190.766,801.2,579,135,989,37,43,93,100,40.0,6,96.5,7
2009-10-27 12:00:00,526.708,2221.0,0,88,5618,37,50,100,100,43.5,13,100.0,0
2009-10-27 18:00:00,140.612,599.6,0,136,713,57,63,55,77,60.0,6,66.0,22
2009-10-28 00:00:00,258.67,1087.0,0,90,1047,46,55,67,88,50.5,9,77.5,21
2009-10-28 06:00:00,161.96599999999998,675.8000000000001,0,137,1123,41,48,93,93,44.5,7,93.0,0
2009-10-28 12:00:00,224.222,951.0,0,90,1570,41,52,82,100,46.5,11,91.0,18
2009-10-28 18:00:00,430.798,1778.6,0,135,5358,57,63,59,67,60.0,6,63.0,8
2009-10-29 00:00:00,451.722,1907.4,1044,101,1267,46,54,82,100,50.0,8,91.0,18
2009-10-29 06:00:00,168.87,706.4,0,125,1084,45,46,93,100,45.5,1,96.5,7
2009-10-29 12:00:00,259.362,1121.6,0,415,1527,45,54,88,100,49.5,9,94.0,12
2009-10-29 18:00:00,717.552,3062.8,0,2076,1213,55,61,68,82,58.0,6,75.0,14
2009-10-30 00:00:00,835.6560000000001,3538.0,765,1509,1853,48,55,82,93,51.5,7,87.5,11
2009-10-30 06:00:00,161.308,683.2,249,99,627,45,48,93,100,46.5,3,96.5,7
2009-10-30 12:00:00,458.028,1909.8,0,505,4444,45,46,93,100,45.5,1,96.5,7
2009-10-30 18:00:00,477.16,2019.4,822,1275,2833,46,50,87,100,48.0,4,93.5,13
2009-10-31 00:00:00,396.862,1654.6,708,126,924,45,48,87,93,46.5,3,90.0,6
2009-10-31 06:00:00,155.16,644.0,0,133,949,41,45,93,100,43.0,4,96.5,7
2009-10-31 12:00:00,338.964,1413.6,0,662,3160,45,50,93,100,47.5,5,96.5,7
2009-10-31 18:00:00,736.4,3089.6,1773,1628,6074,54,61,72,82,57.5,7,77.0,10
2009-11-01 00:00:00,645.418,2704.6,0,91,4454,55,59,88,100,57.0,4,94.0,12
2009-11-01 06:00:00,120.912,505.8,0,138,430,54,55,94,100,54.5,1,97.0,6
2009-11-01 12:00:00,300.398,1277.2,0,91,2121,55,61,94,100,58.0,6,97.0,6
2009-11-01 18:00:00,689.442,2908.6,1068,144,5703,61,64,83,94,62.5,3,88.5,11
2009-11-02 00:00:00,732.416,3067.6,902,97,3961,54,61,88,94,57.5,7,91.0,6
2009-11-02 06:00:00,189.924,794.5999999999999,0,145,1482,50,52,94,94,51.0,2,94.0,0
2009-11-02 12:00:00,290.99,1247.6,397,93,1248,46,50,82,100,48.0,4,91.0,18
2009-11-02 18:00:00,380.436,1614.4,1484,141,1027,50,52,71,82,51.0,2,76.5,11
2009-11-03 00:00:00,642.876,2680.4,0,92,3733,43,46,87,93,44.5,3,90.0,6
2009-11-03 06:00:00,127.136,527.8,0,124,556,43,45,87,100,44.0,2,93.5,13
2009-11-03 12:00:00,496.278,2099.8,1080,567,1855,46,50,93,100,48.0,4,96.5,7
2009-11-03 18:00:00,566.196,2367.4,0,2019,1521,54,55,88,94,54.5,1,91.0,6
2009-11-04 00:00:00,1077.078,4554.8,929,1241,5093,52,55,88,94,53.5,3,91.0,6
2009-11-04 06:00:00,139.038,587.8,0,99,387,48,50,82,94,49.0,2,88.0,12
2009-11-04 12:00:00,315.286,1339.2,1075,429,1661,45,50,76,87,47.5,5,81.5,11
2009-11-04 18:00:00,669.058,2745.4,0,109,6845,50,54,67,82,52.0,4,74.5,15
2009-11-05 00:00:00,678.418,2860.0,0,3371,3353,46,48,81,87,47.0,2,84.0,6
2009-11-05 06:00:00,162.98399999999998,695.4,0,203,946,45,46,81,93,45.5,1,87.0,12
2009-11-05 12:00:00,481.234,1990.4,0,95,5352,45,48,87,93,46.5,3,90.0,6
2009-11-05 18:00:00,182.15,770.2,0,118,384,48,55,67,93,51.5,7,80.0,26
2009-11-06 00:00:00,734.0980000000001,3079.6,1105,116,3186,45,48,87,93,46.5,3,90.0,6
2009-11-06 06:00:00,131.544,539.6,0,91,614,41,45,87,100,43.0,4,93.5,13
2009-11-06 12:00:00,558.14,2302.0,0,130,6481,41,45,87,93,43.0,4,90.0,6
2009-11-06 18:00:00,381.062,1620.4,0,89,3097,46,54,72,87,50.0,8,79.5,15
2009-11-07 00:00:00,319.704,1342.6,0,132,1134,48,50,76,87,49.0,2,81.5,11
2009-11-07 06:00:00,148.98000000000002,612.8,0,91,931,48,48,87,93,48.0,0,90.0,6
2009-11-07 12:00:00,495.936,2074.6,1053,106,4328,46,50,82,93,48.0,4,87.5,11
2009-11-07 18:00:00,490.362,2068.8,1134,124,1663,46,52,71,81,49.0,6,76.0,10
2009-11-08 00:00:00,421.898,1738.8,0,87,3092,39,41,93,93,40.0,2,93.0,0
2009-11-08 06:00:00,167.70600000000002,695.0,0,132,978,41,41,87,93,41.0,0,90.0,6
2009-11-08 12:00:00,629.63,2632.4,1739,87,4065,41,45,87,100,43.0,4,93.5,13
2009-11-08 18:00:00,811.478,3375.0,3202,87,3417,46,48,81,87,47.0,2,84.0,6
2009-11-09 00:00:00,899.188,3727.2,0,1769,6411,41,46,81,93,43.5,5,87.0,12
2009-11-09 06:00:00,141.536,610.8,0,131,624,39,41,87,93,40.0,2,90.0,6
2009-11-09 12:00:00,518.148,2141.2,0,102,4751,39,41,87,93,40.0,2,90.0,6
2009-11-09 18:00:00,158.44,681.4,0,112,329,43,50,71,87,46.5,7,79.0,16
2009-11-10 00:00:00,586.628,2457.8,1125,85,1917,46,48,76,87,47.0,2,81.5,11
2009-11-10 06:00:00,158.424,670.2,0,121,992,36,46,87,100,41.0,10,93.5,13
2009-11-10 12:00:00,537.436,2237.0,0,95,5654,36,45,87,100,40.5,9,93.5,13
2009-11-10 18:00:00,380.084,1567.4,0,87,3156,46,48,76,87,47.0,2,81.5,11
2009-11-11 00:00:00,530.24,2218.8,1118,129,1986,39,46,87,100,42.5,7,93.5,13
2009-11-11 06:00:00,123.304,515.8,0,86,338,39,39,93,100,39.0,0,96.5,7
2009-11-11 12:00:00,298.962,1284.2,0,498,1641,39,41,93,100,40.0,2,96.5,7
2009-11-11 18:00:00,793.52,3359.2000000000003,1738,1926,5184,43,50,66,100,46.5,7,83.0,34
2009-11-12 00:00:00,824.694,3444.4,600,2595,4051,39,45,81,93,42.0,6,87.0,12
2009-11-12 06:00:00,156.558,638.8,0,98,947,43,46,87,100,44.5,3,93.5,13
2009-11-12 12:00:00,547.08,2259.2,0,119,5931,46,52,94,100,49.0,6,97.0,6
2009-11-12 18:00:00,142.656,600.2,0,87,334,55,57,77,82,56.0,2,79.5,5
2009-11-13 00:00:00,616.7719999999999,2626.6000000000004,1486,125,2191,52,54,88,94,53.0,2,91.0,6
2009-11-13 06:00:00,138.19400000000002,594.6,0,97,680,54,55,82,94,54.5,1,88.0,12
2009-11-13 12:00:00,474.042,1973.4,0,89,4528,55,59,72,82,57.0,4,77.0,10
2009-11-13 18:00:00,335.384,1401.2,0,131,2633,61,64,64,72,62.5,3,68.0,8
2009-11-14 00:00:00,585.306,2448.0,1856,90,1337,59,61,68,77,60.0,2,72.5,9
2009-11-14 06:00:00,163.49200000000002,690.6,0,136,970,57,61,63,77,59.0,4,70.0,14
2009-11-14 12:00:00,511.356,2157.2000000000003,524,89,4557,52,59,63,88,55.5,7,75.5,25
2009-11-14 18:00:00,767.142,3209.4,1916,199,6600,55,59,67,72,57.0,4,69.5,5
2009-11-15 00:00:00,1118.466,4675.8,1729,1987,6741,54,55,72,77,54.5,1,74.5,5
2009-11-15 06:00:00,391.666,1629.4,991,176,2050,52,52,82,88,52.0,0,85.0,6
2009-11-15 12:00:00,295.446,1231.4,0,91,3060,50,54,76,87,52.0,4,81.5,11
2009-11-15 18:00:00,456.39,1959.8,0,1701,1793,55,57,72,82,56.0,2,77.0,10
2009-11-16 00:00:00,823.806,3500.4,0,3310,2543,52,54,82,88,53.0,2,85.0,6
2009-11-16 06:00:00,154.76,652.0,0,214,868,50,52,88,100,51.0,2,94.0,12
2009-11-16 12:00:00,597.476,2491.6,1044,114,5562,54,59,88,94,56.5,5,91.0,6
2009-11-16 18:00:00,120.662,504.2,0,124,398,59,59,82,88,59.0,0,85.0,6
2009-11-17 00:00:00,641.57,2692.8,977,93,2526,55,57,88,94,56.0,2,91.0,6
2009-11-17 06:00:00,126.044,532.4,0,138,390,52,55,88,94,53.5,3,91.0,6
2009-11-17 12:00:00,603.05,2508.4,0,92,5907,50,52,94,94,51.0,2,94.0,0
2009-11-17 18:00:00,422.312,1727.6,0,134,2922,50,52,88,94,51.0,2,91.0,6
2009-11-18 00:00:00,556.888,2307.0,0,89,2397,48,50,93,100,49.0,2,96.5,7
2009-11-18 06:00:00,156.744,652.2,0,132,1019,48,50,87,94,49.0,2,90.5,7
2009-11-18 12:00:00,732.046,3078.2,2609,2232,4046,48,52,82,93,50.0,4,87.5,11
2009-11-18 18:00:00,946.048,3961.2,2376,3119,6416,54,55,72,82,54.5,1,77.0,10
2009-11-19 00:00:00,804.336,3376.0,1027,2172,2306,48,52,82,93,50.0,4,87.5,11
2009-11-19 06:00:00,154.974,642.4,0,152,895,45,48,87,93,46.5,3,90.0,6
2009-11-19 12:00:00,543.636,2245.2,0,111,5391,43,45,93,100,44.0,2,96.5,7
2009-11-19 18:00:00,337.466,1404.8,0,112,3407,46,55,77,93,50.5,9,85.0,16
2009-11-20 00:00:00,438.772,1829.2,0,106,1243,52,54,82,88,53.0,2,85.0,6
2009-11-20 06:00:00,168.226,731.0,0,79,1132,46,50,87,93,48.0,4,90.0,6
2009-11-20 12:00:00,661.262,2751.0,0,110,5682,48,55,82,88,51.5,7,85.0,6
2009-11-20 18:00:00,365.058,1503.0,0,111,3015,57,61,72,82,59.0,4,77.0,10
2009-11-21 00:00:00,766.47,3211.8,843,107,2987,55,57,82,82,56.0,2,82.0,0
2009-11-21 06:00:00,158.71,648.6,0,77,833,54,55,82,88,54.5,1,85.0,6
2009-11-21 12:00:00,538.232,2230.4,0,112,5676,52,54,88,94,53.0,2,91.0,6
2009-11-21 18:00:00,684.532,2900.0,2684,491,3670,59,61,63,72,60.0,2,67.5,9
2009-11-22 00:00:00,1115.382,4705.8,3010,1317,2374,59,61,63,72,60.0,2,67.5,9
2009-11-22 06:00:00,285.526,1228.2,765,113,1477,52,61,68,94,56.5,9,81.0,26
2009-11-22 12:00:00,330.184,1394.8,0,78,2932,50,54,77,94,52.0,4,85.5,17
2009-11-22 18:00:00,673.83,2843.6,811,111,5110,52,57,67,82,54.5,5,74.5,15
2009-11-23 00:00:00,1161.436,4891.6,5198,109,6578,46,50,81,87,48.0,4,84.0,6
2009-11-23 06:00:00,118.748,490.2000000000001,0,107,337,46,48,81,87,47.0,2,84.0,6
2009-11-23 12:00:00,460.868,1913.4,0,75,4047,48,54,82,94,51.0,6,88.0,12
2009-11-23 18:00:00,179.464,731.4,0,111,337,54,55,77,88,54.5,1,82.5,11
2009-11-24 00:00:00,712.042,2965.8,0,109,3509,54,55,88,94,54.5,1,91.0,6
2009-11-24 06:00:00,161.572,664.4,0,88,384,55,55,88,94,55.0,0,91.0,6
2009-11-24 12:00:00,681.902,2853.4,1058,616,5190,55,57,82,94,56.0,2,88.0,12
2009-11-24 18:00:00,350.142,1445.2,0,114,1137,57,59,67,82,58.0,2,74.5,15
2009-11-25 00:00:00,935.24,3936.0,1433,3761,2375,54,57,72,82,55.5,3,77.0,10
2009-11-25 06:00:00,125.91,541.2,0,164,392,50,52,82,88,51.0,2,85.0,6
2009-11-25 12:00:00,609.0,2526.6,0,619,5950,48,52,71,87,50.0,4,79.0,16
2009-11-25 18:00:00,612.8240000000001,2594.2,0,4124,1999,48,54,72,94,51.0,6,83.0,22
2009-11-26 00:00:00,632.396,2647.2,745,176,2255,46,48,87,93,47.0,2,90.0,6
2009-11-26 06:00:00,123.112,508.8,0,115,470,45,46,87,93,45.5,1,90.0,6
2009-11-26 12:00:00,639.964,2636.2,1037,111,6217,45,50,82,93,47.5,5,87.5,11
2009-11-26 18:00:00,274.432,1139.8,0,109,1367,50,54,72,82,52.0,4,77.0,10
2009-11-27 00:00:00,562.1179999999999,2355.4,1225,72,2015,50,52,76,87,51.0,2,81.5,11
2009-11-27 06:00:00,158.114,656.4,0,109,1036,48,50,76,93,49.0,2,84.5,17
2009-11-27 12:00:00,502.132,2078.0,0,107,5388,45,48,76,81,46.5,3,78.5,5
2009-11-27 18:00:00,322.446,1321.0,0,73,3640,48,52,66,76,50.0,4,71.0,10
2009-11-28 00:00:00,397.334,1648.6,0,107,1535,45,48,76,87,46.5,3,81.5,11
2009-11-28 06:00:00,111.966,460.2,0,107,337,45,46,81,93,45.5,1,87.0,12
2009-11-28 12:00:00,468.048,1932.8,0,71,4398,46,50,82,87,48.0,4,84.5,5
2009-11-28 18:00:00,605.356,2593.6,2286,110,3050,50,52,82,94,51.0,2,88.0,12
2009-11-29 00:00:00,673.58,2798.2,913,98,6565,50,52,67,94,51.0,2,80.5,27
2009-11-29 06:00:00,131.348,538.6,0,85,340,50,52,58,71,51.0,2,64.5,13
2009-11-29 12:00:00,496.89,2069.8,0,1989,3042,46,50,66,87,48.0,4,76.5,21
2009-11-29 18:00:00,506.33,2112.2,1073,858,1495,46,50,76,82,48.0,4,79.0,6
2009-11-30 00:00:00,516.394,2157.8,0,129,2951,43,46,81,87,44.5,3,84.0,6
2009-11-30 06:00:00,193.336,811.2,0,91,1039,41,43,87,93,42.0,2,90.0,6
2009-11-30 12:00:00,516.97,2160.8,0,89,4650,41,43,87,93,42.0,2,90.0,6
2009-11-30 18:00:00,454.924,1840.4,0,98,4883,43,45,87,87,44.0,2,87.0,0
2009-12-01 00:00:00,579.96,2419.8,1080,83,1467,41,45,87,93,43.0,4,90.0,6
2009-12-01 06:00:00,180.5,768.2,0,103,1037,43,45,87,93,44.0,2,90.0,6
2009-12-01 12:00:00,681.298,2830.4,0,74,6008,41,45,81,87,43.0,4,84.0,6
2009-12-01 18:00:00,335.036,1384.6,0,106,1884,45,48,71,76,46.5,3,73.5,5
2009-12-02 00:00:00,559.544,2329.6,0,71,1892,41,45,71,81,43.0,4,76.0,10
2009-12-02 06:00:00,189.096,790.6,0,106,949,39,41,76,87,40.0,2,81.5,11
2009-12-02 12:00:00,631.562,2641.0,0,311,5590,41,43,81,100,42.0,2,90.5,19
2009-12-02 18:00:00,794.4540000000001,3305.8,1143,3827,3773,45,48,87,93,46.5,3,90.0,6
2009-12-03 00:00:00,730.556,3083.0,0,2808,2539,48,50,93,100,49.0,2,96.5,7
2009-12-03 06:00:00,159.53,693.2,0,108,452,48,50,87,94,49.0,2,90.5,7
2009-12-03 12:00:00,643.576,2669.8,1039,111,5804,48,50,82,93,49.0,2,87.5,11
2009-12-03 18:00:00,163.34,690.4,0,90,553,45,50,76,87,47.5,5,81.5,11
2009-12-04 00:00:00,513.242,2129.0,0,93,3097,37,45,76,87,41.0,8,81.5,11
2009-12-04 06:00:00,143.738,653.4,0,106,288,37,39,87,100,38.0,2,93.5,13
2009-12-04 12:00:00,628.53,2627.4,0,70,4835,34,41,81,93,37.5,7,87.0,12
2009-12-04 18:00:00,337.938,1402.8,0,106,2380,45,48,62,76,46.5,3,69.0,14
2009-12-05 00:00:00,601.088,2495.0,1158,70,1631,43,43,81,87,43.0,0,84.0,6
2009-12-05 06:00:00,179.798,768.0,0,104,870,41,43,93,100,42.0,2,96.5,7
2009-12-05 12:00:00,536.178,2238.4,0,71,4155,45,52,87,94,48.5,7,90.5,7
2009-12-05 18:00:00,467.094,2032.8,774,106,1829,52,55,82,88,53.5,3,85.0,6
2009-12-06 00:00:00,1168.692,4929.2,3048,70,6470,52,54,88,94,53.0,2,91.0,6
2009-12-06 06:00:00,294.212,1235.6,0,107,2304,52,54,77,94,53.0,2,85.5,17
2009-12-06 12:00:00,462.252,1964.8,1096,1597,2046,54,54,77,88,54.0,0,82.5,11
2009-12-06 18:00:00,824.12,3486.6,1045,2359,3436,48,55,82,88,51.5,7,85.0,6
2009-12-07 00:00:00,797.704,3369.0,709,112,4634,43,46,87,93,44.5,3,90.0,6
2009-12-07 06:00:00,154.57,688.8,0,71,801,41,43,93,93,42.0,2,93.0,0
2009-12-07 12:00:00,699.086,2917.2,1132,106,5140,39,43,93,100,41.0,4,96.5,7
2009-12-07 18:00:00,329.426,1365.0,0,89,2737,43,50,93,100,46.5,7,96.5,7
2009-12-08 00:00:00,559.5559999999999,2323.8,0,92,1613,46,50,87,93,48.0,4,90.0,6
2009-12-08 06:00:00,160.688,682.4,0,106,917,41,45,81,93,43.0,4,87.0,12
2009-12-08 12:00:00,631.752,2624.2,0,70,5872,39,45,76,93,42.0,6,84.5,17
2009-12-08 18:00:00,437.508,1798.4,0,104,3117,45,46,76,87,45.5,1,81.5,11
2009-12-09 00:00:00,776.936,3233.0,1108,70,5470,45,46,87,100,45.5,1,93.5,13
2009-12-09 06:00:00,119.672,513.4,0,105,333,46,46,93,100,46.0,0,96.5,7
2009-12-09 12:00:00,552.178,2296.4,1010,69,5091,48,52,93,100,50.0,4,96.5,7
2009-12-09 18:00:00,478.936,2016.4,0,3073,532,54,55,94,100,54.5,1,97.0,6
2009-12-10 00:00:00,651.57,2733.6,1044,108,2015,55,55,94,94,55.0,0,94.0,0
2009-12-10 06:00:00,118.748,507.0,0,82,338,50,55,88,94,52.5,5,91.0,6
2009-12-10 12:00:00,615.704,2567.6,0,92,6178,48,52,82,94,50.0,4,88.0,12
2009-12-10 18:00:00,519.982,2112.8,0,105,6854,48,54,67,82,51.0,6,74.5,15
2009-12-11 00:00:00,799.852,3396.0,2823,70,2029,37,46,81,93,41.5,9,87.0,12
2009-12-11 06:00:00,119.082,519.2,0,104,334,34,37,93,100,35.5,3,96.5,7
2009-12-11 12:00:00,613.962,2535.6,0,96,5910,36,46,81,100,41.0,10,90.5,19
2009-12-11 18:00:00,468.422,1926.0,0,77,3273,46,48,71,81,47.0,2,76.0,10
2009-12-12 00:00:00,582.996,2407.6,1546,108,1734,45,46,76,81,45.5,1,78.5,5
2009-12-12 06:00:00,125.36,533.8,0,89,348,37,43,81,87,40.0,6,84.0,6
2009-12-12 12:00:00,488.266,2014.6,0,82,4363,37,41,81,93,39.0,4,87.0,12
2009-12-12 18:00:00,563.256,2386.0,0,2446,1856,41,41,76,81,41.0,0,78.5,5
2009-12-13 00:00:00,639.498,2641.8,1087,1503,1631,37,39,81,81,38.0,2,81.0,0
2009-12-13 06:00:00,147.462,608.8,0,133,764,34,36,81,87,35.0,2,84.0,6
2009-12-13 12:00:00,433.148,1795.8,1060,117,2418,32,36,81,93,34.0,4,87.0,12
2009-12-13 18:00:00,848.982,3522.8,2924,85,5761,36,37,70,81,36.5,1,75.5,11
2009-12-14 00:00:00,709.222,2950.0,0,82,4235,32,36,75,81,34.0,4,78.0,6
2009-12-14 06:00:00,149.536,617.8,0,83,806,30,32,80,86,31.0,2,83.0,6
2009-12-14 12:00:00,429.398,1764.4,0,81,3948,28,30,69,75,29.0,2,72.0,6
2009-12-14 18:00:00,254.87,1041.2,0,81,646,32,34,60,64,33.0,2,62.0,4
2009-12-15 00:00:00,961.058,3952.6,1090,2035,5342,30,32,60,64,31.0,2,62.0,4
2009-12-15 06:00:00,174.88,732.0,0,149,926,27,30,64,80,28.5,3,72.0,16
2009-12-15 12:00:00,601.54,2478.0,0,81,5304,25,28,74,86,26.5,3,80.0,12
2009-12-15 18:00:00,603.534,2431.2,0,81,5878,30,32,55,64,31.0,2,59.5,9
2009-12-16 00:00:00,560.1619999999999,2299.8,1111,81,1976,30,32,60,75,31.0,2,67.5,15
2009-12-16 06:00:00,139.39800000000002,571.4000000000001,0,75,708,30,30,75,75,30.0,0,75.0,0
2009-12-16 12:00:00,514.208,2106.4,0,542,4687,28,32,64,80,30.0,4,72.0,16
2009-12-16 18:00:00,342.796,1430.6,0,2189,1041,30,34,52,64,32.0,4,58.0,12
2009-12-17 00:00:00,398.472,1642.0,1143,137,1668,21,28,64,93,24.5,7,78.5,29
2009-12-17 06:00:00,150.882,627.0,0,83,887,23,28,80,86,25.5,5,83.0,6
2009-12-17 12:00:00,590.614,2414.2,0,82,6239,27,28,80,100,27.5,1,90.0,20
2009-12-17 18:00:00,419.348,1674.6,0,81,4930,27,30,93,100,28.5,3,96.5,7
2009-12-18 00:00:00,556.338,2255.6,0,62,2339,0,34,93,100,17.0,34,96.5,7
2009-12-18 06:00:00,111.702,465.2,0,63,249,0,34,93,100,17.0,34,96.5,7
2009-12-18 12:00:00,651.21,2688.0,1195,81,5454,27,30,86,100,28.5,3,93.0,14
2009-12-18 18:00:00,410.504,1660.8000000000002,0,80,3386,27,28,64,86,27.5,1,75.0,22
2009-12-19 00:00:00,571.29,2340.4,0,80,2377,23,25,80,86,24.0,2,83.0,6
2009-12-19 06:00:00,514.302,2067.8,0,79,765,19,25,86,93,22.0,6,89.5,7
2009-12-19 12:00:00,790.6279999999999,3249.2,0,154,5994,25,28,64,93,26.5,3,78.5,29
2009-12-19 18:00:00,680.128,2759.0,1165,1269,6704,25,30,55,69,27.5,5,62.0,14
2009-12-20 00:00:00,219.276,913.8,0,1160,218,25,27,64,69,26.0,2,66.5,5
2009-12-20 06:00:00,186.056,757.2,0,114,1252,25,28,74,93,26.5,3,83.5,19
2009-12-20 12:00:00,502.608,2058.8,1237,40,3781,28,32,86,100,30.0,4,93.0,14
2009-12-20 18:00:00,256.098,1040.4,0,80,2082,32,36,93,100,34.0,4,96.5,7
2009-12-21 00:00:00,199.404,815.6,0,79,680,25,30,93,100,27.5,5,96.5,7
2009-12-21 06:00:00,142.212,582.0,0,79,750,25,28,93,100,26.5,3,96.5,7
2009-12-21 12:00:00,302.504,1242.2,0,39,1361,0,36,93,100,18.0,36,96.5,7
2009-12-21 18:00:00,640.74,2579.8,0,81,6071,36,36,87,100,36.0,0,93.5,13
2009-12-22 00:00:00,949.51,3916.8,3293,83,3291,0,34,93,100,17.0,34,96.5,7
2009-12-22 06:00:00,109.71,462.6,0,43,0,36,37,93,93,36.5,1,93.0,0
2009-12-22 12:00:00,585.0840000000001,2400.4,0,79,5808,34,36,93,100,35.0,2,96.5,7
2009-12-22 18:00:00,411.392,1683.2,0,81,3406,36,36,93,93,36.0,0,93.0,0
2009-12-23 00:00:00,781.836,3180.4,0,82,6615,34,36,93,100,35.0,2,96.5,7
2009-12-23 06:00:00,500.88,2002.6,0,40,6739,32,34,100,100,33.0,2,100.0,0
2009-12-23 12:00:00,410.232,1699.2,1143,80,1961,32,36,93,100,34.0,4,96.5,7
2009-12-23 18:00:00,144.11,594.2,0,82,628,37,41,87,100,39.0,4,93.5,13
2009-12-24 00:00:00,399.978,1638.8000000000002,0,82,1877,34,39,87,100,36.5,5,93.5,13
2009-12-24 06:00:00,131.028,537.8,0,51,579,30,34,93,100,32.0,4,96.5,7
2009-12-24 12:00:00,326.43,1344.0,0,72,976,32,34,93,100,33.0,2,96.5,7
2009-12-24 18:00:00,1043.956,4257.6,0,4323,6904,36,41,93,100,38.5,5,96.5,7
2009-12-25 00:00:00,1404.48,5803.4,5184,1129,6739,41,45,93,100,43.0,4,96.5,7
2009-12-25 06:00:00,307.56,1269.2,0,120,3127,37,39,93,100,38.0,2,96.5,7
2009-12-25 12:00:00,446.356,1879.0,0,2242,2134,39,41,87,93,40.0,2,90.0,6
2009-12-25 18:00:00,746.5260000000001,3110.4,3371,1473,2201,43,46,62,81,44.5,3,71.5,19
2009-12-26 00:00:00,627.206,2565.2,0,60,6826,37,39,75,87,38.0,2,81.0,12
2009-12-26 06:00:00,376.346,1530.0,0,89,4600,32,34,87,93,33.0,2,90.0,6
2009-12-26 12:00:00,533.64,2238.4,1186,2200,3066,30,36,87,100,33.0,6,93.5,13
2009-12-26 18:00:00,571.496,2392.0,0,1343,3405,37,43,76,87,40.0,6,81.5,11
2009-12-27 00:00:00,702.136,2920.8,0,662,4976,34,36,87,93,35.0,2,90.0,6
2009-12-27 06:00:00,203.676,834.2,0,96,1551,34,36,81,87,35.0,2,84.0,6
2009-12-27 12:00:00,315.284,1312.4,1169,88,1169,36,39,93,93,37.5,3,93.0,0
2009-12-27 18:00:00,745.992,3092.8,650,84,6229,43,48,71,81,45.5,5,76.0,10
2009-12-28 00:00:00,930.5,3925.8,2399,50,3501,39,45,76,87,42.0,6,81.5,11
2009-12-28 06:00:00,162.254,682.8,0,90,883,34,37,93,93,35.5,3,93.0,0
2009-12-28 12:00:00,507.424,2119.6,1141,91,4071,34,36,93,100,35.0,2,96.5,7
2009-12-28 18:00:00,579.732,2357.8,0,1751,5011,37,43,81,100,40.0,6,90.5,19
2009-12-29 00:00:00,844.688,3527.8,1034,131,4969,37,39,93,93,38.0,2,93.0,0
2009-12-29 06:00:00,136.196,571.2,0,54,515,37,39,93,100,38.0,2,96.5,7
2009-12-29 12:00:00,625.864,2635.2,0,94,2699,39,50,93,100,44.5,11,96.5,7
2009-12-29 18:00:00,788.612,3241.2,1260,110,4774,52,55,88,100,53.5,3,94.0,12
2009-12-30 00:00:00,497.296,2066.6,0,88,2217,52,54,88,88,53.0,2,88.0,0
2009-12-30 06:00:00,123.674,524.8,0,73,333,50,52,88,94,51.0,2,91.0,6
2009-12-30 12:00:00,692.95,2916.4,2141,728,4040,50,52,87,94,51.0,2,90.5,7
2009-12-30 18:00:00,806.308,3372.0,2361,107,5728,50,52,82,87,51.0,2,84.5,5
2009-12-31 00:00:00,828.178,3509.4,782,3631,2383,46,48,93,100,47.0,2,96.5,7
2009-12-31 06:00:00,162.922,691.0,0,115,881,46,46,93,100,46.0,0,96.5,7
2009-12-31 12:00:00,531.734,2212.2,0,78,5093,45,46,87,93,45.5,1,90.0,6
2009-12-31 18:00:00,588.828,2426.2,0,91,6862,37,46,93,93,41.5,9,93.0,0
2010-01-01 00:00:00,928.408,3889.0,0,103,6573,34,37,93,100,35.5,3,96.5,7
2010-01-01 06:00:00,257.95,1071.6,0,100,752,32,34,87,93,33.0,2,90.0,6
2010-01-01 12:00:00,287.77,1192.8,0,94,1249,32,32,87,93,32.0,0,90.0,6
2010-01-01 18:00:00,511.842,2130.6,2304,47,1315,34,34,70,81,34.0,0,75.5,11
2010-01-02 00:00:00,166.69,698.4000000000001,0,86,242,27,34,70,86,30.5,7,78.0,16
2010-01-02 06:00:00,165.838,692.2,0,86,1079,25,30,93,100,27.5,5,96.5,7
2010-01-02 12:00:00,246.58,1038.2,0,85,1904,25,34,81,100,29.5,9,90.5,19
2010-01-02 18:00:00,247.064,1045.2,40,85,1110,34,39,61,81,36.5,5,71.0,20
2010-01-03 00:00:00,649.354,2712.4,761,42,2331,28,32,87,93,30.0,4,90.0,6
2010-01-03 06:00:00,163.402,693.8,0,85,826,28,30,93,100,29.0,2,96.5,7
2010-01-03 12:00:00,504.434,2091.4,1636,682,3404,28,32,93,100,30.0,4,96.5,7
2010-01-03 18:00:00,814.91,3399.0,1112,2535,4552,34,39,70,87,36.5,5,78.5,17
2010-01-04 00:00:00,600.708,2519.4,1094,1618,1292,27,34,80,87,30.5,7,83.5,7
2010-01-04 06:00:00,166.20600000000002,694.8,0,85,775,21,25,80,93,23.0,4,86.5,13
2010-01-04 12:00:00,572.588,2342.2,0,82,6071,19,23,80,93,21.0,4,86.5,13
2010-01-04 18:00:00,212.702,888.4,0,57,1149,25,28,69,80,26.5,3,74.5,11
2010-01-05 00:00:00,652.636,2697.8,0,68,2817,23,25,80,86,24.0,2,83.0,6
2010-01-05 06:00:00,127.442,540.0,0,83,248,21,23,80,93,22.0,2,86.5,13
2010-01-05 12:00:00,700.364,2904.8,1205,66,6043,19,27,74,93,23.0,8,83.5,19
2010-01-05 18:00:00,715.18,2903.6,0,59,6886,28,32,64,75,30.0,4,69.5,11
2010-01-06 00:00:00,676.794,2791.4,580,85,3291,21,28,80,93,24.5,7,86.5,13
2010-01-06 06:00:00,148.358,617.6,548,44,321,23,25,93,100,24.0,2,96.5,7
2010-01-06 12:00:00,634.8399999999999,2605.2,0,557,6558,23,25,86,100,24.0,2,93.0,14
2010-01-06 18:00:00,385.706,1610.2,0,2527,1686,25,27,86,93,26.0,2,89.5,7
2010-01-07 00:00:00,608.276,2528.4,1183,128,2794,27,27,93,93,27.0,0,93.0,0
2010-01-07 06:00:00,126.658,564.8,0,52,367,27,27,93,93,27.0,0,93.0,0
2010-01-07 12:00:00,542.4639999999999,2225.8,0,77,5545,25,27,93,100,26.0,2,96.5,7
2010-01-07 18:00:00,304.106,1234.4,0,84,2648,23,28,80,93,25.5,5,86.5,13
2010-01-08 00:00:00,796.214,3275.4,1198,42,4376,14,21,93,93,17.5,7,93.0,0
2010-01-08 06:00:00,113.388,473.4,0,83,251,9,12,85,100,10.5,3,92.5,15
2010-01-08 12:00:00,637.16,2614.4,0,41,6217,12,21,86,93,16.5,9,89.5,7
2010-01-08 18:00:00,515.0,2124.8,0,82,4933,23,27,80,86,25.0,4,83.0,6
2010-01-09 00:00:00,531.66,2205.4,0,788,1130,25,27,80,86,26.0,2,83.0,6
2010-01-09 06:00:00,150.05,619.4,0,68,793,25,27,74,80,26.0,2,77.0,6
2010-01-09 12:00:00,575.302,2364.6,0,736,5891,27,27,74,100,27.0,0,87.0,26
2010-01-09 18:00:00,569.554,2388.8,1812,2832,1805,27,28,80,93,27.5,1,86.5,13
2010-01-10 00:00:00,1041.994,4323.4,969,1219,6245,28,30,80,86,29.0,2,83.0,6
2010-01-10 06:00:00,250.02,1021.8,0,61,2412,30,30,86,93,30.0,0,89.5,7
2010-01-10 12:00:00,459.364,1920.2,543,469,2653,30,30,86,93,30.0,0,89.5,7
2010-01-10 18:00:00,1185.786,4945.6,2492,1480,6703,0,30,80,93,15.0,30,86.5,13
2010-01-11 00:00:00,613.2959999999999,2518.4,529,22,2340,30,30,86,93,30.0,0,89.5,7
2010-01-11 06:00:00,156.82,655.4,0,165,895,30,30,86,93,30.0,0,89.5,7
2010-01-11 12:00:00,556.608,2280.6,0,0,5896,30,32,87,93,31.0,2,90.0,6
2010-01-11 18:00:00,194.322,802.2,0,175,680,32,34,75,81,33.0,2,78.0,6
2010-01-12 00:00:00,610.934,2504.4,1251,0,2808,32,32,80,80,32.0,0,80.0,0
2010-01-12 06:00:00,117.762,505.6,0,161,247,30,30,86,86,30.0,0,86.0,0
2010-01-12 12:00:00,682.41,2837.2000000000003,0,296,6057,30,30,86,86,30.0,0,86.0,0
2010-01-12 18:00:00,482.366,1994.0,552,3032,3265,32,32,80,87,32.0,0,83.5,7
2010-01-13 00:00:00,0.0,0.0,0,0,0,30,32,80,87,31.0,2,83.5,7
2010-01-13 06:00:00,0.0,0.0,0,0,0,28,28,93,100,28.0,0,96.5,7
2010-01-13 12:00:00,0.0,0.0,0,0,0,28,34,93,100,31.0,6,96.5,7
2010-01-13 18:00:00,0.0,0.0,0,0,0,36,37,93,100,36.5,1,96.5,7
2010-01-14 00:00:00,0.0,0.0,0,0,0,34,36,93,100,35.0,2,96.5,7
2010-01-14 06:00:00,0.0,0.0,0,0,0,36,37,93,100,36.5,1,96.5,7
2010-01-14 12:00:00,0.0,0.0,0,0,0,34,36,93,100,35.0,2,96.5,7
2010-01-14 18:00:00,0.0,0.0,0,0,0,37,41,76,87,39.0,4,81.5,11
2010-01-15 00:00:00,618.488,2587.4,1890,84,1893,37,39,81,93,38.0,2,87.0,12
2010-01-15 06:00:00,108.866,453.8,0,41,243,0,36,93,100,18.0,36,96.5,7
2010-01-15 12:00:00,595.972,2457.4,0,80,5785,34,36,93,100,35.0,2,96.5,7
2010-01-15 18:00:00,519.336,2134.8,0,80,4562,37,39,87,100,38.0,2,93.5,13
2010-01-16 00:00:00,972.586,4076.4,1957,2751,2956,37,39,81,93,38.0,2,87.0,12
2010-01-16 06:00:00,150.298,627.0,0,136,796,36,37,93,93,36.5,1,93.0,0
2010-01-16 12:00:00,733.802,3032.4,0,1225,5983,37,39,87,93,38.0,2,90.0,6
2010-01-16 18:00:00,665.444,2773.4,1790,968,4827,39,41,87,93,40.0,2,90.0,6
2010-01-17 00:00:00,600.568,2523.6,815,86,2046,41,46,93,100,43.5,5,96.5,7
2010-01-17 06:00:00,147.698,617.4,0,84,765,46,48,76,93,47.0,2,84.5,17
2010-01-17 12:00:00,299.53,1253.0,0,83,2622,41,46,81,87,43.5,5,84.0,6
2010-01-17 18:00:00,635.696,2653.0,816,81,5642,46,50,71,81,48.0,4,76.0,10
2010-01-18 00:00:00,823.632,3427.6,1176,50,6015,37,43,87,93,40.0,6,90.0,6
2010-01-18 06:00:00,236.454,973.8,0,72,2309,34,36,93,100,35.0,2,96.5,7
2010-01-18 12:00:00,642.538,2646.8,0,81,6029,36,39,93,100,37.5,3,96.5,7
2010-01-18 18:00:00,353.09000000000003,1452.0,0,81,2730,39,39,100,100,39.0,0,100.0,0
2010-01-19 00:00:00,649.0160000000001,2734.4,617,61,1913,37,39,93,100,38.0,2,96.5,7
2010-01-19 06:00:00,122.706,510.0,0,61,246,36,36,93,100,36.0,0,96.5,7
2010-01-19 12:00:00,700.998,2914.2,1142,81,6515,34,36,93,100,35.0,2,96.5,7
2010-01-19 18:00:00,684.446,2794.0,0,81,6790,34,36,93,100,35.0,2,96.5,7
2010-01-20 00:00:00,925.358,3868.4,902,430,5760,34,36,93,100,35.0,2,96.5,7
2010-01-20 06:00:00,123.52,516.4,0,167,245,32,34,93,100,33.0,2,96.5,7
2010-01-20 12:00:00,762.484,3176.2,1159,528,6098,32,34,93,100,33.0,2,96.5,7
2010-01-20 18:00:00,542.058,2258.2,0,2574,3229,34,41,93,100,37.5,7,96.5,7
2010-01-21 00:00:00,923.666,3856.6,1158,72,4991,41,43,87,93,42.0,2,90.0,6
2010-01-21 06:00:00,114.324,483.2000000000001,0,68,243,39,41,87,93,40.0,2,90.0,6
2010-01-21 12:00:00,669.496,2769.8,0,131,6251,39,39,87,93,39.0,0,90.0,6
2010-01-21 18:00:00,443.704,1816.6,0,134,4872,41,45,71,81,43.0,4,76.0,10
2010-01-22 00:00:00,910.332,3803.6,894,116,5085,39,39,87,93,39.0,0,90.0,6
2010-01-22 06:00:00,279.678,1186.0,0,68,2736,37,39,93,100,38.0,2,96.5,7
2010-01-22 12:00:00,586.0319999999999,2423.2,0,51,6265,39,41,93,100,40.0,2,96.5,7
2010-01-22 18:00:00,345.5,1435.0,0,117,3351,45,46,66,81,45.5,1,73.5,15
2010-01-23 00:00:00,579.416,2419.6,699,116,2160,41,45,71,76,43.0,4,73.5,5
2010-01-23 06:00:00,138.524,592.2,425,117,242,41,41,76,76,41.0,0,76.0,0
2010-01-23 12:00:00,753.9499999999999,3166.2,686,533,6435,41,41,76,76,41.0,0,76.0,0
2010-01-23 18:00:00,516.504,2195.8,218,125,3087,41,41,76,76,41.0,0,76.0,0
2010-01-24 00:00:00,1199.532,5076.2,1825,3311,6257,41,41,76,76,41.0,0,76.0,0
2010-01-24 06:00:00,186.504,773.5999999999999,0,209,1150,36,37,93,93,36.5,1,93.0,0
2010-01-24 12:00:00,609.9639999999999,2556.2,1166,121,3602,36,39,93,100,37.5,3,96.5,7
2010-01-24 18:00:00,972.384,4078.8,2328,2289,4538,41,43,87,100,42.0,2,93.5,13
2010-01-25 00:00:00,500.568,2102.8,2,141,1756,41,41,76,93,41.0,0,84.5,17
2010-01-25 06:00:00,164.184,681.2,0,117,926,34,41,76,93,37.5,7,84.5,17
2010-01-25 12:00:00,575.822,2371.6,0,113,6224,34,39,93,100,36.5,5,96.5,7
2010-01-25 18:00:00,267.464,1102.2,0,114,2288,41,43,70,81,42.0,2,75.5,11
2010-01-26 00:00:00,923.04,3837.0,1368,111,6698,37,39,81,93,38.0,2,87.0,12
2010-01-26 06:00:00,340.54,1399.8,526,104,3245,32,36,87,93,34.0,4,90.0,6
2010-01-26 12:00:00,610.8340000000001,2524.0,0,101,5286,30,32,86,93,31.0,2,89.5,7
2010-01-26 18:00:00,462.396,1884.0,0,103,2648,30,32,75,86,31.0,2,80.5,11
2010-01-27 00:00:00,653.794,2693.2,0,87,5064,28,30,74,80,29.0,2,77.0,6
2010-01-27 06:00:00,378.118,1545.2,0,59,4485,23,27,80,86,25.0,4,83.0,6
2010-01-27 12:00:00,633.836,2625.6,1168,388,5928,23,27,74,86,25.0,4,80.0,12
2010-01-27 18:00:00,667.76,2794.4,0,4517,2609,28,36,56,69,32.0,8,62.5,13
2010-01-28 00:00:00,1081.188,4540.6,876,1439,5132,32,34,65,70,33.0,2,67.5,5
2010-01-28 06:00:00,326.774,1338.4,0,137,3502,34,37,65,100,35.5,3,82.5,35
2010-01-28 12:00:00,617.956,2548.2,911,120,5624,36,41,87,100,38.5,5,93.5,13
2010-01-28 18:00:00,239.52,996.2,0,127,940,41,43,76,81,42.0,2,78.5,5
2010-01-29 00:00:00,925.984,3848.4,1121,120,4921,37,41,81,93,39.0,4,87.0,12
2010-01-29 06:00:00,325.13,1339.4,0,125,3563,37,39,87,100,38.0,2,93.5,13
2010-01-29 12:00:00,867.97,3612.2,1488,548,6206,37,39,93,93,38.0,2,93.0,0
2010-01-29 18:00:00,615.3720000000001,2492.0,0,58,6925,39,45,87,93,42.0,6,90.0,6
2010-01-30 00:00:00,284.51800000000003,1165.6,0,120,1367,36,41,75,87,38.5,5,81.0,12
2010-01-30 06:00:00,138.03,576.8,0,128,490,28,34,81,93,31.0,6,87.0,12
2010-01-30 12:00:00,777.384,3243.8,0,2483,5826,27,34,87,93,30.5,7,90.0,6
2010-01-30 18:00:00,825.49,3524.8,2662,1476,5378,36,37,60,70,36.5,1,65.0,10
2010-01-31 00:00:00,1101.824,4617.0,578,3457,6197,25,36,70,93,30.5,11,81.5,23
2010-01-31 06:00:00,132.992,570.0,0,157,287,23,27,93,100,25.0,4,96.5,7
2010-01-31 12:00:00,293.166,1208.2,0,662,1672,30,36,70,93,33.0,6,81.5,23
2010-01-31 18:00:00,578.52,2408.4,533,460,5788,37,39,60,70,38.0,2,65.0,10
2010-02-01 00:00:00,794.518,3304.6,1182,101,4822,32,36,75,87,34.0,4,81.0,12
2010-02-01 06:00:00,151.664,634.4,0,96,901,30,32,75,86,31.0,2,80.5,11
2010-02-01 12:00:00,547.414,2249.4,0,90,6040,30,36,80,93,33.0,6,86.5,13
2010-02-01 18:00:00,226.506,919.0,0,94,2029,36,43,57,93,39.5,7,75.0,36
2010-02-02 00:00:00,768.194,3192.4,1111,87,5653,32,37,70,93,34.5,5,81.5,23
2010-02-02 06:00:00,228.534,934.2,0,91,2051,30,34,93,93,32.0,4,93.0,0
2010-02-02 12:00:00,646.59,2639.8,0,96,6659,34,37,87,93,35.5,3,90.0,6
2010-02-02 18:00:00,465.86,1889.4,0,95,6076,37,41,87,93,39.0,4,90.0,6
2010-02-03 00:00:00,816.448,3390.2,0,100,6750,43,45,87,93,44.0,2,90.0,6
2010-02-03 06:00:00,325.83,1333.8,0,100,3429,45,46,87,93,45.5,1,90.0,6
2010-02-03 12:00:00,689.11,2853.8,1150,476,5975,46,48,87,93,47.0,2,90.0,6
2010-02-03 18:00:00,891.41,3680.0,0,5425,6144,48,50,76,87,49.0,2,81.5,11
2010-02-04 00:00:00,996.664,4185.2,1084,2422,5582,46,48,82,93,47.0,2,87.5,11
2010-02-04 06:00:00,417.408,1708.0,0,169,5179,41,45,87,93,43.0,4,90.0,6
2010-02-04 12:00:00,649.3240000000001,2666.6,0,116,6806,37,41,87,93,39.0,4,90.0,6
2010-02-04 18:00:00,510.258,2074.8,0,124,6775,45,50,62,76,47.5,5,69.0,14
2010-02-05 00:00:00,739.28,3117.8,1074,123,4983,41,45,66,81,43.0,4,73.5,15
2010-02-05 06:00:00,324.91200000000003,1360.0,0,120,3162,43,46,76,100,44.5,3,88.0,24
2010-02-05 12:00:00,548.446,2270.4,0,116,5758,45,46,93,100,45.5,1,96.5,7
2010-02-05 18:00:00,445.714,1855.4,0,123,3927,48,54,62,87,51.0,6,74.5,25
2010-02-06 00:00:00,779.8199999999999,3262.8,902,115,5161,43,48,71,87,45.5,5,79.0,16
2010-02-06 06:00:00,172.926,724.6,278,118,902,41,43,87,93,42.0,2,90.0,6
2010-02-06 12:00:00,658.548,2758.6,0,531,6064,43,46,93,100,44.5,3,96.5,7
2010-02-06 18:00:00,706.2339999999999,2979.0,1094,1425,4490,43,48,87,93,45.5,5,90.0,6
2010-02-07 00:00:00,1175.278,4961.6,2952,135,6401,43,43,87,93,43.0,0,90.0,6
2010-02-07 06:00:00,249.844,1033.4,973,136,960,39,43,87,100,41.0,4,93.5,13
2010-02-07 12:00:00,383.462,1592.6,0,567,2764,37,39,93,93,38.0,2,93.0,0
2010-02-07 18:00:00,324.386,1364.6,0,2010,355,41,43,65,81,42.0,2,73.0,16
2010-02-08 00:00:00,668.016,2816.0,1763,1124,1467,37,41,70,87,39.0,4,78.5,17
2010-02-08 06:00:00,114.482,469.6,0,64,272,37,37,87,87,37.0,0,87.0,0
2010-02-08 12:00:00,781.988,3243.0,0,87,5966,36,37,87,93,36.5,1,90.0,6
2010-02-08 18:00:00,689.358,2811.8,0,142,6834,37,39,81,93,38.0,2,87.0,12
2010-02-09 00:00:00,996.41,4142.4,1161,138,6692,34,37,75,87,35.5,3,81.0,12
2010-02-09 06:00:00,506.7720000000001,2063.8,0,129,6469,32,34,75,93,33.0,2,84.0,18
2010-02-09 12:00:00,594.15,2453.8,0,122,5954,30,32,93,100,31.0,2,96.5,7
2010-02-09 18:00:00,348.6,1419.2,0,57,1527,28,30,86,93,29.0,2,89.5,7
2010-02-10 00:00:00,971.41,4028.2,1214,102,5819,27,28,74,86,27.5,1,80.0,12
2010-02-10 06:00:00,256.668,1061.2,0,96,2330,23,27,74,93,25.0,4,83.5,19
2010-02-10 12:00:00,638.318,2649.2,0,516,5942,23,32,80,93,27.5,9,86.5,13
2010-02-10 18:00:00,452.272,1876.4,0,2276,1992,28,37,75,100,32.5,9,87.5,25
2010-02-11 00:00:00,597.284,2484.2,1219,88,1950,27,28,74,86,27.5,1,80.0,12
2010-02-11 06:00:00,153.686,623.6,0,87,921,25,27,80,93,26.0,2,86.5,13
2010-02-11 12:00:00,511.798,2100.4,0,80,5355,23,27,74,93,25.0,4,83.5,19
2010-02-11 18:00:00,256.19,1044.0,0,82,1796,27,28,80,93,27.5,1,86.5,13
2010-02-12 00:00:00,448.094,1858.6,0,81,1844,28,28,74,93,28.0,0,83.5,19
2010-02-12 06:00:00,156.222,634.6,0,76,924,27,28,74,80,27.5,1,77.0,6
2010-02-12 12:00:00,757.608,3151.4,1241,76,6158,25,27,80,86,26.0,2,83.0,6
2010-02-12 18:00:00,489.45,1981.8,0,79,6202,27,34,65,80,30.5,7,72.5,15
2010-02-13 00:00:00,489.718,2019.8,0,81,1927,25,32,69,80,28.5,7,74.5,11
2010-02-13 06:00:00,115.404,475.8,0,77,247,25,27,80,86,26.0,2,83.0,6
2010-02-13 12:00:00,675.1800000000001,2796.6,1142,691,5556,25,27,80,86,26.0,2,83.0,6
2010-02-13 18:00:00,993.522,4111.4,696,4446,6216,27,28,74,86,27.5,1,80.0,12
2010-02-14 00:00:00,567.45,2327.6,0,78,6691,27,28,74,80,27.5,1,77.0,6
2010-02-14 06:00:00,276.848,1116.0,0,81,1842,28,28,74,74,28.0,0,74.0,0
2010-02-14 12:00:00,232.322,945.6,0,77,1541,28,28,74,74,28.0,0,74.0,0
2010-02-14 18:00:00,607.77,2486.0,0,81,6771,28,28,74,74,28.0,0,74.0,0
2010-02-15 00:00:00,569.7579999999999,2403.8,1223,79,3036,28,28,74,74,28.0,0,74.0,0
2010-02-15 06:00:00,129.114,526.2,0,84,506,30,32,80,86,31.0,2,83.0,6
2010-02-15 12:00:00,573.896,2367.8,0,81,5996,27,32,80,100,29.5,5,90.0,20
2010-02-15 18:00:00,355.048,1430.6,0,83,4020,36,36,65,70,36.0,0,67.5,5
2010-02-16 00:00:00,1039.074,4376.4,3468,84,5543,28,34,69,75,31.0,6,72.0,6
2010-02-16 06:00:00,143.846,591.4,0,83,248,23,28,74,86,25.5,5,80.0,12
2010-02-16 12:00:00,670.086,2768.2,1188,85,5917,21,32,64,93,26.5,11,78.5,29
2010-02-16 18:00:00,503.328,2043.2,0,82,4839,36,39,52,60,37.5,3,56.0,8
2010-02-17 00:00:00,480.496,2010.8,757,67,1816,27,36,65,86,31.5,9,75.5,21
2010-02-17 06:00:00,181.124,738.0,0,57,852,23,32,87,93,27.5,9,90.0,6
2010-02-17 12:00:00,615.898,2559.6000000000004,1163,498,5128,32,36,87,100,34.0,4,93.5,13
2010-02-17 18:00:00,693.072,2889.0,0,5996,1873,37,39,93,100,38.0,2,96.5,7
2010-02-18 00:00:00,564.466,2368.8,1131,85,2248,37,39,93,100,38.0,2,96.5,7
2010-02-18 06:00:00,151.756,616.2,0,91,879,36,37,93,100,36.5,1,96.5,7
2010-02-18 12:00:00,567.6,2339.0,0,95,5922,34,39,93,100,36.5,5,96.5,7
2010-02-18 18:00:00,533.014,2189.4,965,98,5553,43,52,62,93,47.5,9,77.5,31
2010-02-19 00:00:00,508.786,2110.4,0,101,2530,41,45,87,93,43.0,4,90.0,6
2010-02-19 06:00:00,153.312,633.4,0,99,866,37,43,87,93,40.0,6,90.0,6
2010-02-19 12:00:00,685.222,2872.8,1728,95,5437,36,41,76,100,38.5,5,88.0,24
2010-02-19 18:00:00,333.04200000000003,1378.4,1,102,3150,43,46,50,66,44.5,3,58.0,16
2010-02-20 00:00:00,781.996,3257.4,395,101,5090,32,41,57,93,36.5,9,75.0,36
2010-02-20 06:00:00,244.27,995.8,0,98,2128,30,34,93,100,32.0,4,96.5,7
2010-02-20 12:00:00,624.04,2591.0,1173,96,5849,32,36,93,100,34.0,4,96.5,7
2010-02-20 18:00:00,343.212,1428.2,16,96,3437,36,39,81,100,37.5,3,90.5,19
2010-02-21 00:00:00,772.206,3258.6,2559,92,3056,36,37,81,93,36.5,1,87.0,12
2010-02-21 06:00:00,155.98,655.6,0,94,789,36,37,81,93,36.5,1,87.0,12
2010-02-21 12:00:00,621.764,2655.4,1469,2465,3119,34,37,93,100,35.5,3,96.5,7
2010-02-21 18:00:00,1146.38,4849.200000000001,4436,4522,6626,39,48,66,93,43.5,9,79.5,27
2010-02-22 00:00:00,816.19,3415.0,0,1061,6549,41,46,71,81,43.5,5,76.0,10
2010-02-22 06:00:00,215.86,893.4,0,177,1637,41,43,81,100,42.0,2,90.5,19
2010-02-22 12:00:00,690.364,2904.4,1074,1727,5858,43,52,67,93,47.5,9,80.0,26
2010-02-22 18:00:00,170.628,737.4,319,151,502,52,57,58,67,54.5,5,62.5,9
2010-02-23 00:00:00,397.184,1678.4,0,112,2162,50,55,67,87,52.5,5,77.0,20
2010-02-23 06:00:00,162.05599999999998,678.2,0,113,995,48,50,87,93,49.0,2,90.0,6
2010-02-23 12:00:00,508.384,2116.0,0,110,4871,48,50,93,100,49.0,2,96.5,7
2010-02-23 18:00:00,165.85,690.4,0,116,1024,52,55,77,88,53.5,3,82.5,11
2010-02-24 00:00:00,624.99,2642.0,0,2662,1916,46,54,77,93,50.0,8,85.0,16
2010-02-24 06:00:00,127.474,542.8,0,173,310,45,46,87,93,45.5,1,90.0,6
2010-02-24 12:00:00,687.508,2866.8,1166,1241,5666,43,46,93,100,44.5,3,96.5,7
2010-02-24 18:00:00,550.702,2253.8,0,155,6831,48,54,72,87,51.0,6,79.5,15
2010-02-25 00:00:00,548.5939999999999,2289.8,1094,113,1508,48,50,82,93,49.0,2,87.5,11
2010-02-25 06:00:00,185.992,770.2,0,111,1013,46,50,82,93,48.0,4,87.5,11
2010-02-25 12:00:00,515.898,2140.0,0,114,5167,46,48,87,93,47.0,2,90.0,6
2010-02-25 18:00:00,623.824,2553.2,0,115,6883,46,54,87,100,50.0,8,93.5,13
2010-02-26 00:00:00,554.49,2321.0,0,134,2057,50,54,82,94,52.0,4,88.0,12
2010-02-26 06:00:00,180.322,744.2,0,137,1072,48,50,76,87,49.0,2,81.5,11
2010-02-26 12:00:00,457.612,1915.0,0,700,2666,43,46,76,100,44.5,3,88.0,24
2010-02-26 18:00:00,594.948,2479.4,0,1497,5192,45,52,41,76,48.5,7,58.5,35
2010-02-27 00:00:00,887.274,3702.0,1146,120,5891,43,48,46,76,45.5,5,61.0,30
2010-02-27 06:00:00,147.2,607.0,0,106,747,39,43,76,93,41.0,4,84.5,17
2010-02-27 12:00:00,452.89,1912.6,856,104,3196,39,50,62,100,44.5,11,81.0,38
2010-02-27 18:00:00,709.206,2973.6,2346,113,6741,52,54,47,58,53.0,2,52.5,11
2010-02-28 00:00:00,455.76,1924.0,541,118,3674,45,52,58,100,48.5,7,79.0,42
2010-02-28 06:00:00,232.49,958.8,0,125,1039,46,54,82,100,50.0,8,91.0,18
2010-02-28 12:00:00,179.328,744.2,0,123,416,45,55,63,93,50.0,10,78.0,30
2010-02-28 18:00:00,177.648,741.2,0,109,1230,46,48,66,81,47.0,2,73.5,15
2010-03-01 00:00:00,122.2,524.0,0,130,267,41,46,61,76,43.5,5,68.5,15
2010-03-01 06:00:00,176.97,738.4,0,138,1260,34,39,81,93,36.5,5,87.0,12
2010-03-01 12:00:00,252.9,1082.6,778,133,812,32,45,76,100,38.5,13,88.0,24
2010-03-01 18:00:00,478.104,1965.4,4,103,4083,48,50,47,54,49.0,2,50.5,7
2010-03-02 00:00:00,390.754,1624.8,1003,97,960,43,46,57,81,44.5,3,69.0,24
2010-03-02 06:00:00,184.51,758.8,0,98,240,41,43,87,93,42.0,2,90.0,6
2010-03-02 12:00:00,214.6,893.4,0,92,1205,41,48,71,93,44.5,7,82.0,22
2010-03-02 18:00:00,169.258,709.6,0,97,1074,48,52,44,66,50.0,4,55.0,22
2010-03-03 00:00:00,198.538,843.0,0,137,1086,41,48,53,61,44.5,7,57.0,8
2010-03-03 06:00:00,183.82,778.2,0,138,271,39,41,61,65,40.0,2,63.0,4
2010-03-03 12:00:00,431.624,1779.6,0,93,5258,37,43,57,70,40.0,6,63.5,13
2010-03-03 18:00:00,145.486,629.4,0,98,579,46,50,32,43,48.0,4,37.5,11
2010-03-04 00:00:00,174.904,748.4,0,96,1113,41,46,40,49,43.5,5,44.5,9
2010-03-04 06:00:00,122.234,530.2,0,95,241,37,41,45,60,39.0,4,52.5,15
2010-03-04 12:00:00,187.43,793.0,0,93,1229,36,41,53,65,38.5,5,59.0,12
2010-03-04 18:00:00,185.044,788.8,0,108,1222,43,45,43,49,44.0,2,46.0,6
2010-03-05 00:00:00,188.172,778.4,0,140,236,36,43,46,60,39.5,7,53.0,14
2010-03-05 06:00:00,240.808,989.0,0,101,1239,28,36,70,93,32.0,8,81.5,23
2010-03-05 12:00:00,162.528,685.4,0,82,242,28,37,70,93,32.5,9,81.5,23
2010-03-05 18:00:00,417.77,1722.6,1108,84,3589,39,43,42,61,41.0,4,51.5,19
2010-03-06 00:00:00,312.62,1306.4,0,84,848,28,41,53,86,34.5,13,69.5,33
2010-03-06 06:00:00,123.646,526.8,0,84,271,30,32,80,93,31.0,2,86.5,13
2010-03-06 12:00:00,288.12,1195.8,0,129,2587,34,43,66,93,38.5,9,79.5,27
2010-03-06 18:00:00,202.126,847.2,0,124,873,39,45,49,57,42.0,6,53.0,8
2010-03-07 00:00:00,180.82,751.8000000000001,0,82,239,32,39,48,60,35.5,7,54.0,12
2010-03-07 06:00:00,228.548,928.4,0,76,1030,27,32,60,69,29.5,5,64.5,9
2010-03-07 12:00:00,211.524,864.6,0,74,1154,27,32,51,69,29.5,5,60.0,18
2010-03-07 18:00:00,311.356,1306.4,0,2376,239,36,39,31,44,37.5,3,37.5,13
2010-03-08 00:00:00,621.044,2612.6,0,2148,1256,32,37,33,47,34.5,5,40.0,14
2010-03-08 06:00:00,194.708,849.0,0,129,1058,28,30,51,55,29.0,2,53.0,4
2010-03-08 12:00:00,893.11,3721.6,1441,3971,6063,27,36,35,55,31.5,9,45.0,20
2010-03-08 18:00:00,904.548,3765.0,2773,2492,6790,39,43,26,34,41.0,4,30.0,8
2010-03-09 00:00:00,564.732,2355.6,0,1053,2060,32,39,49,80,35.5,7,64.5,31
2010-03-09 06:00:00,134.538,582.0,0,128,247,28,30,69,80,29.0,2,74.5,11
2010-03-09 12:00:00,641.2579999999999,2662.6,846,81,5919,28,34,52,74,31.0,6,63.0,22
2010-03-09 18:00:00,388.944,1605.6,0,80,2685,36,39,33,44,37.5,3,38.5,11
2010-03-10 00:00:00,595.3720000000001,2466.0,0,108,2042,32,37,38,47,34.5,5,42.5,9
2010-03-10 06:00:00,171.952,716.0,0,117,962,28,32,51,55,30.0,4,53.0,4
2010-03-10 12:00:00,627.168,2578.8,1167,94,5984,28,37,30,55,32.5,9,42.5,25
2010-03-10 18:00:00,625.324,2540.0,0,82,6813,39,48,24,34,43.5,9,29.0,10
2010-03-11 00:00:00,398.188,1648.8,0,82,1157,37,45,37,60,41.0,8,48.5,23
2010-03-11 06:00:00,174.778,725.8,0,80,1148,32,36,70,81,34.0,4,75.5,11
2010-03-11 12:00:00,550.75,2268.0,0,79,6031,28,34,70,86,31.0,6,78.0,16
2010-03-11 18:00:00,314.358,1291.1999999999998,0,79,3584,36,45,42,65,40.5,9,53.5,23
2010-03-12 00:00:00,911.204,3835.8,2071,82,4943,34,41,49,75,37.5,7,62.0,26
2010-03-12 06:00:00,178.446,747.0,0,95,1251,28,32,80,93,30.0,4,86.5,13
2010-03-12 12:00:00,571.31,2373.8,1150,132,5512,30,39,75,93,34.5,9,84.0,18
2010-03-12 18:00:00,442.368,1792.6,0,100,4880,37,43,57,81,40.0,6,69.0,24
2010-03-13 00:00:00,453.3,1886.6,541,84,2433,39,43,53,70,41.0,4,61.5,17
2010-03-13 06:00:00,116.916,501.6,0,84,274,37,39,70,87,38.0,2,78.5,17
2010-03-13 12:00:00,659.716,2758.2,1329,80,5954,39,45,71,93,42.0,6,82.0,22
2010-03-13 18:00:00,779.664,3239.0,1519,3261,5082,45,45,57,66,45.0,0,61.5,9
2010-03-14 00:00:00,826.714,3444.4,0,2109,6663,43,43,61,66,43.0,0,63.5,5
2010-03-14 06:00:00,232.818,975.8,0,124,1979,37,41,65,75,39.0,4,70.0,10
2010-03-14 12:00:00,240.69,1025.8,0,429,1402,39,43,70,76,41.0,4,73.0,6
2010-03-14 18:00:00,474.536,2029.2,2411,275,2033,43,48,54,76,45.5,5,65.0,22
2010-03-15 00:00:00,618.6700000000001,2585.8,1053,90,1687,39,48,53,81,43.5,9,67.0,28
2010-03-15 06:00:00,160.904,682.2,0,149,894,34,41,76,100,37.5,7,88.0,24
2010-03-15 12:00:00,514.982,2128.4,0,106,5979,34,50,62,93,42.0,16,77.5,31
2010-03-15 18:00:00,453.372,1868.4,0,92,5285,52,54,47,58,53.0,2,52.5,11
2010-03-16 00:00:00,662.592,2777.8,778,89,2895,37,52,50,87,44.5,15,68.5,37
2010-03-16 06:00:00,155.316,660.0,0,92,860,36,37,87,93,36.5,1,90.0,6
2010-03-16 12:00:00,583.304,2406.2,0,127,6122,34,50,58,93,42.0,16,75.5,35
2010-03-16 18:00:00,275.6,1148.4,0,148,1283,54,57,31,44,55.5,3,37.5,13
2010-03-17 00:00:00,528.43,2209.2,0,90,1818,41,55,36,66,48.0,14,51.0,30
2010-03-17 06:00:00,126.536,540.6,0,92,274,34,39,70,81,36.5,5,75.5,11
2010-03-17 12:00:00,619.482,2568.4,1136,428,6158,36,52,50,81,44.0,16,65.5,31
2010-03-17 18:00:00,694.592,2882.0,0,3251,5312,54,63,24,47,58.5,9,35.5,23
2010-03-18 00:00:00,568.52,2401.0,0,2080,1361,50,59,31,54,54.5,9,42.5,23
2010-03-18 06:00:00,140.668,607.0,0,182,602,41,48,54,70,44.5,7,62.0,16
2010-03-18 12:00:00,539.074,2240.4,0,161,5854,41,55,41,65,48.0,14,53.0,24
2010-03-18 18:00:00,252.95,1069.2,0,112,639,59,66,23,36,62.5,7,29.5,13
2010-03-19 00:00:00,629.99,2631.6,1147,115,3750,59,64,28,42,61.5,5,35.0,14
2010-03-19 06:00:00,222.386,920.2,0,114,983,55,57,48,58,56.0,2,53.0,10
2010-03-19 12:00:00,492.712,2039.2,0,116,5481,54,59,59,72,56.5,5,65.5,13
2010-03-19 18:00:00,412.438,1723.1999999999998,0,184,4524,63,66,49,55,64.5,3,52.0,6
2010-03-20 00:00:00,535.848,2238.0,0,182,1603,55,64,49,100,59.5,9,74.5,51
2010-03-20 06:00:00,131.732,549.6,0,25,969,55,57,94,100,56.0,2,97.0,6
2010-03-20 12:00:00,0.0,0.0,0,0,0,54,57,82,94,55.5,3,88.0,12
2010-03-20 18:00:00,0.0,0.0,0,0,0,57,61,77,82,59.0,4,79.5,5
2010-03-21 00:00:00,0.0,0.0,0,0,0,57,59,82,94,58.0,2,88.0,12
2010-03-21 06:00:00,0.0,0.0,0,0,0,50,57,82,94,53.5,7,88.0,12
2010-03-21 12:00:00,0.0,0.0,0,0,0,46,50,82,87,48.0,4,84.5,5
2010-03-21 18:00:00,342.686,1447.4,1076,101,2770,50,55,58,82,52.5,5,70.0,24
2010-03-22 00:00:00,574.596,2443.8,594,2706,910,45,54,62,81,49.5,9,71.5,19
2010-03-22 06:00:00,171.03,725.6,0,139,907,41,46,87,100,43.5,5,93.5,13
2010-03-22 12:00:00,527.67,2191.0,0,77,6253,39,54,62,100,46.5,15,81.0,38
2010-03-22 18:00:00,458.798,1884.8,0,177,5589,54,59,51,59,56.5,5,55.0,8
2010-03-23 00:00:00,461.092,1948.0,1142,164,1110,45,57,55,93,51.0,12,74.0,38
2010-03-23 06:00:00,165.2,709.0,0,143,1055,39,45,87,100,42.0,6,93.5,13
2010-03-23 12:00:00,542.944,2278.6,0,148,5355,39,55,67,93,47.0,16,80.0,26
2010-03-23 18:00:00,497.246,2154.8,1794,168,4423,55,61,52,63,58.0,6,57.5,11
2010-03-24 00:00:00,616.772,2591.0,1098,694,2274,50,59,55,82,54.5,9,68.5,27
2010-03-24 06:00:00,163.242,696.2,0,148,979,46,48,87,87,47.0,2,87.0,0
2010-03-24 12:00:00,698.482,2901.8,0,1749,6383,45,61,55,87,53.0,16,71.0,32
2010-03-24 18:00:00,644.156,2701.4,0,3786,4152,63,66,46,52,64.5,3,49.0,6
2010-03-25 00:00:00,488.872,2055.4,1075,149,1303,59,64,49,59,61.5,5,54.0,10
2010-03-25 06:00:00,201.522,846.2,0,153,968,54,59,55,67,56.5,5,61.0,12
2010-03-25 12:00:00,621.652,2559.4,0,153,6430,54,57,67,72,55.5,3,69.5,5
2010-03-25 18:00:00,292.182,1222.2,0,156,2479,54,64,52,94,59.0,10,73.0,42
2010-03-26 00:00:00,564.528,2346.4,0,149,3920,54,55,72,82,54.5,1,77.0,10
2010-03-26 06:00:00,123.106,524.6,0,138,348,48,52,71,82,50.0,4,76.5,11
2010-03-26 12:00:00,589.04,2452.0,1078,167,5874,46,50,81,82,48.0,4,81.5,1
2010-03-26 18:00:00,353.446,1479.2,0,176,3194,48,54,67,82,51.0,6,74.5,15
2010-03-27 00:00:00,585.692,2454.4,0,201,3131,46,50,76,82,48.0,4,79.0,6
2010-03-27 06:00:00,172.928,741.0,0,146,873,43,46,81,93,44.5,3,87.0,12
2010-03-27 12:00:00,476.548,2007.0,1067,144,3762,45,52,82,100,48.5,7,91.0,18
2010-03-27 18:00:00,607.604,2543.4,0,800,6658,52,55,62,88,53.5,3,75.0,26
2010-03-28 00:00:00,590.89,2475.2,0,1990,1190,48,54,62,87,51.0,6,74.5,25
2010-03-28 06:00:00,286.776,1191.8000000000002,0,180,2125,46,48,87,93,47.0,2,90.0,6
2010-03-28 12:00:00,346.678,1458.6,0,1969,1686,45,50,87,100,47.5,5,93.5,13
2010-03-28 18:00:00,403.95,1762.8,0,2766,1091,50,57,77,94,53.5,7,85.5,17
2010-03-29 00:00:00,760.81,3253.2,1083,2980,2216,54,55,82,94,54.5,1,88.0,12
2010-03-29 06:00:00,170.064,730.0,0,152,984,52,52,94,94,52.0,0,94.0,0
2010-03-29 12:00:00,517.938,2152.8,0,158,5942,52,55,77,94,53.5,3,85.5,17
2010-03-29 18:00:00,528.538,2178.0,0,173,6855,57,64,56,82,60.5,7,69.0,26
2010-03-30 00:00:00,406.198,1745.2,0,153,1639,52,59,72,94,55.5,7,83.0,22
2010-03-30 06:00:00,211.22,974.6,0,146,1110,50,52,88,94,51.0,2,91.0,6
2010-03-30 12:00:00,658.2660000000001,2797.4,1080,140,5711,48,50,82,94,49.0,2,88.0,12
2010-03-30 18:00:00,490.04,2042.8,680,144,4199,41,55,67,93,48.0,14,80.0,26
2010-03-31 00:00:00,546.928,2301.8,0,141,2745,46,48,62,93,47.0,2,77.5,31
2010-03-31 06:00:00,140.826,604.0,0,137,591,41,45,76,87,43.0,4,81.5,11
2010-03-31 12:00:00,641.744,2694.4,1067,678,5941,41,50,62,87,45.5,9,74.5,25
2010-03-31 18:00:00,571.054,2436.6,0,5315,2179,48,52,43,66,50.0,4,54.5,23
2010-04-01 00:00:00,570.178,2419.6,0,183,3330,41,46,57,76,43.5,5,66.5,19
2010-04-01 06:00:00,164.064,685.8,0,150,886,37,39,70,75,38.0,2,72.5,5
2010-04-01 12:00:00,514.758,2123.0,0,117,5660,36,48,57,87,42.0,12,72.0,30
2010-04-01 18:00:00,302.478,1279.6,633,127,2652,46,54,33,53,50.0,8,43.0,20
2010-04-02 00:00:00,706.14,2937.4,1147,123,5195,39,54,33,70,46.5,15,51.5,37
2010-04-02 06:00:00,140.206,591.6,0,123,700,41,43,61,76,42.0,2,68.5,15
2010-04-02 12:00:00,580.072,2384.2,0,118,6143,41,46,76,87,43.5,5,81.5,11
2010-04-02 18:00:00,460.828,1882.8,0,120,4817,46,52,71,93,49.0,6,82.0,22
2010-04-03 00:00:00,467.516,1957.6,0,122,1414,43,50,61,87,46.5,7,74.0,26
2010-04-03 06:00:00,153.184,635.8,0,116,863,45,45,87,93,45.0,0,90.0,6
2010-04-03 12:00:00,672.7719999999999,2794.2,1631,167,5910,45,48,82,93,46.5,3,87.5,11
2010-04-03 18:00:00,571.424,2339.2,147,195,6726,48,52,71,87,50.0,4,79.0,16
2010-04-04 00:00:00,407.898,1677.0,0,170,4195,45,50,81,87,47.5,5,84.0,6
2010-04-04 06:00:00,188.386,793.8,0,158,1150,43,46,76,87,44.5,3,81.5,11
2010-04-04 12:00:00,324.74,1368.6,0,139,1747,43,48,71,93,45.5,5,82.0,22
2010-04-04 18:00:00,779.908,3268.8,358,402,6667,50,52,58,76,51.0,2,67.0,18
2010-04-05 00:00:00,397.354,1661.8,739,132,3123,43,52,46,87,47.5,9,66.5,41
2010-04-05 06:00:00,152.19,639.0,0,99,946,34,37,81,93,35.5,3,87.0,12
2010-04-05 12:00:00,410.874,1738.0,1265,745,2494,32,52,58,100,42.0,20,79.0,42
2010-04-05 18:00:00,184.314,774.0,490,440,273,54,57,47,58,55.5,3,52.5,11
2010-04-06 00:00:00,371.442,1556.0,0,152,1790,41,54,51,76,47.5,13,63.5,25
2010-04-06 06:00:00,158.244,662.8,0,137,970,37,41,87,93,39.0,4,90.0,6
2010-04-06 12:00:00,538.192,2245.2,0,141,5020,37,57,41,93,47.0,20,67.0,52
2010-04-06 18:00:00,516.372,2120.4,0,164,4889,61,66,28,34,63.5,5,31.0,6
2010-04-07 00:00:00,613.044,2544.4,1154,171,1597,41,66,28,87,53.5,25,57.5,59
2010-04-07 06:00:00,177.058,750.2,0,148,1061,45,48,71,87,46.5,3,79.0,16
2010-04-07 12:00:00,575.754,2387.0,0,511,6025,48,61,52,82,54.5,13,67.0,30
2010-04-07 18:00:00,400.458,1698.0,0,2672,2307,61,64,48,55,62.5,3,51.5,7
2010-04-08 00:00:00,443.712,1854.2,1077,109,1969,48,59,67,82,53.5,11,74.5,15
2010-04-08 06:00:00,174.004,728.6,0,169,1074,50,50,82,94,50.0,0,88.0,12
2010-04-08 12:00:00,535.136,2218.4,0,172,5195,48,50,82,93,49.0,2,87.5,11
2010-04-08 18:00:00,341.178,1415.4,0,164,3399,52,55,58,76,53.5,3,67.0,18
2010-04-09 00:00:00,598.902,2490.6,145,164,3654,50,54,62,82,52.0,4,72.0,20
2010-04-09 06:00:00,121.568,519.8,0,137,345,41,46,66,81,43.5,5,73.5,15
2010-04-09 12:00:00,589.062,2435.6,1088,143,6019,41,55,54,81,48.0,14,67.5,27
2010-04-09 18:00:00,308.998,1293.0,0,147,3116,59,63,39,48,61.0,4,43.5,9
2010-04-10 00:00:00,213.722,893.2,0,139,1115,50,61,45,67,55.5,11,56.0,22
2010-04-10 06:00:00,153.126,652.0,0,132,810,46,50,71,81,48.0,4,76.0,10
2010-04-10 12:00:00,467.108,1953.0,0,136,5105,46,57,48,87,51.5,11,67.5,39
2010-04-10 18:00:00,206.354,893.2,0,525,814,59,61,45,51,60.0,2,48.0,6
2010-04-11 00:00:00,363.62,1522.0,1044,167,2204,50,57,48,71,53.5,7,59.5,23
2010-04-11 06:00:00,177.524,742.6,0,136,1052,41,48,71,87,44.5,7,79.0,16
2010-04-11 12:00:00,352.882,1490.6,0,128,3032,41,52,58,87,46.5,11,72.5,29
2010-04-11 18:00:00,289.096,1210.0,0,135,2501,52,54,47,50,53.0,2,48.5,3
2010-04-12 00:00:00,783.308,3371.8,5499,155,2265,45,50,50,66,47.5,5,58.0,16
2010-04-12 06:00:00,155.498,656.0,0,154,895,39,43,70,87,41.0,4,78.5,17
2010-04-12 12:00:00,533.672,2226.4,359,146,5940,39,46,66,87,42.5,7,76.5,21
2010-04-12 18:00:00,343.058,1430.0,301,149,3477,48,55,44,66,51.5,7,55.0,22
2010-04-13 00:00:00,407.198,1684.2,0,162,1637,48,52,54,66,50.0,4,60.0,12
2010-04-13 06:00:00,159.21,678.8,0,149,1011,43,48,71,87,45.5,5,79.0,16
2010-04-13 12:00:00,601.412,2516.2,0,162,6060,45,52,71,87,48.5,7,79.0,16
2010-04-13 18:00:00,377.384,1565.0,1097,161,3028,52,61,42,72,56.5,9,57.0,30
2010-04-14 00:00:00,374.698,1564.8,0,174,2934,50,54,62,87,52.0,4,74.5,25
2010-04-14 06:00:00,164.358,693.0,0,157,1030,43,48,76,87,45.5,5,81.5,11
2010-04-14 12:00:00,601.406,2494.8,0,686,5922,43,50,76,87,46.5,7,81.5,11
2010-04-14 18:00:00,443.45,1892.6,0,4910,357,52,59,55,71,55.5,7,63.0,16
2010-04-15 00:00:00,451.15,1899.2,1132,118,1885,50,57,54,94,53.5,7,74.0,40
2010-04-15 06:00:00,163.072,690.6,0,132,1091,43,48,82,93,45.5,5,87.5,11
2010-04-15 12:00:00,538.264,2235.0,0,196,6030,43,55,58,87,49.0,12,72.5,29
2010-04-15 18:00:00,511.416,2113.2,524,183,5558,55,59,45,54,57.0,4,49.5,9
2010-04-16 00:00:00,659.4259999999999,2773.8,2002,147,2988,50,59,45,76,54.5,9,60.5,31
2010-04-16 06:00:00,135.044,574.8,0,153,389,45,52,67,76,48.5,7,71.5,9
2010-04-16 12:00:00,546.922,2276.6,1048,136,4859,43,52,62,81,47.5,9,71.5,19
2010-04-16 18:00:00,506.076,2144.8,816,152,4912,54,59,41,58,56.5,5,49.5,17
2010-04-17 00:00:00,374.02,1556.8,973,151,2463,48,55,47,67,51.5,7,57.0,20
2010-04-17 06:00:00,170.12,713.6,0,146,1019,39,46,66,81,42.5,7,73.5,15
2010-04-17 12:00:00,662.428,2771.8,0,2604,5551,37,54,58,87,45.5,17,72.5,29
2010-04-17 18:00:00,487.008,2062.8,553,191,4211,57,64,30,51,60.5,7,40.5,21
2010-04-18 00:00:00,238.156,1001.0,0,183,1790,46,63,37,66,54.5,17,51.5,29
2010-04-18 06:00:00,201.882,843.0,0,184,1257,41,48,57,81,44.5,7,69.0,24
2010-04-18 12:00:00,332.59000000000003,1403.1999999999998,577,132,2275,43,63,39,76,53.0,20,57.5,37
2010-04-18 18:00:00,427.968,1784.8,527,147,4306,66,72,26,32,69.0,6,29.0,6
2010-04-19 00:00:00,513.6659999999999,2133.4,0,155,4712,52,68,26,50,60.0,16,38.0,24
2010-04-19 06:00:00,134.676,570.0,0,143,398,45,52,62,76,48.5,7,69.0,14
2010-04-19 12:00:00,431.124,1811.2,0,649,3974,43,61,42,81,52.0,18,61.5,39
2010-04-19 18:00:00,614.12,2543.0,0,1355,6843,63,70,26,37,66.5,7,31.5,11
2010-04-20 00:00:00,528.674,2222.4,1230,2108,2259,55,66,26,51,60.5,11,38.5,25
2010-04-20 06:00:00,175.058,733.0,0,157,1135,43,50,54,81,46.5,7,67.5,27
2010-04-20 12:00:00,549.168,2316.8,0,169,5851,48,61,39,62,54.5,13,50.5,23
2010-04-20 18:00:00,555.766,2287.8,0,195,6821,61,63,37,48,62.0,2,42.5,11
2010-04-21 00:00:00,553.6360000000001,2339.4,1388,198,2861,50,59,48,54,54.5,9,51.0,6
2010-04-21 06:00:00,192.674,815.0,0,185,1067,36,46,53,81,41.0,10,67.0,28
2010-04-21 12:00:00,470.28,1952.6,0,148,4850,34,55,44,87,44.5,21,65.5,43
2010-04-21 18:00:00,426.574,1772.2,0,148,4981,59,63,32,42,61.0,4,37.0,10
2010-04-22 00:00:00,490.386,2021.0,0,154,2004,46,59,44,53,52.5,13,48.5,9
2010-04-22 06:00:00,193.174,819.6,0,134,1032,41,48,57,65,44.5,7,61.0,8
2010-04-22 12:00:00,440.782,1862.4,0,139,3801,41,55,41,70,48.0,14,55.5,29
2010-04-22 18:00:00,578.208,2407.0,1062,191,6343,55,59,31,38,57.0,4,34.5,7
2010-04-23 00:00:00,248.74,1054.0,0,189,1316,50,57,31,58,53.5,7,44.5,27
2010-04-23 06:00:00,130.10399999999998,554.8,0,186,399,45,48,46,53,46.5,3,49.5,7
2010-04-23 12:00:00,509.628,2108.8,0,143,5643,39,57,36,70,48.0,18,53.0,34
2010-04-23 18:00:00,362.196,1521.2,0,148,3811,61,66,21,27,63.5,5,24.0,6
2010-04-24 00:00:00,178.608,762.0,0,146,1128,50,64,22,44,57.0,14,33.0,22
2010-04-24 06:00:00,176.986,754.6,0,143,1180,45,50,54,66,47.5,5,60.0,12
2010-04-24 12:00:00,131.424,569.0,0,145,412,45,66,32,62,55.5,21,47.0,30
2010-04-24 18:00:00,317.832,1419.6,507,426,1419,68,73,19,28,70.5,5,23.5,9
2010-04-25 00:00:00,892.176,3859.8,3938,769,5212,52,73,20,50,62.5,21,35.0,30
2010-04-25 06:00:00,697.284,2900.0,0,403,3010,46,50,66,87,48.0,4,76.5,21
2010-04-25 12:00:00,324.81600000000003,1412.0,0,1783,964,48,68,46,82,58.0,20,64.0,36
2010-04-25 18:00:00,348.328,1467.4,0,42,2566,68,72,38,49,70.0,4,43.5,11
2010-04-26 00:00:00,172.314,731.6,0,122,1055,52,68,40,77,60.0,16,58.5,37
2010-04-26 06:00:00,134.802,580.0,0,132,442,46,59,67,87,52.5,13,77.0,20
2010-04-26 12:00:00,202.604,860.1999999999999,0,77,1190,45,59,67,100,52.0,14,83.5,33
2010-04-26 18:00:00,269.698,1153.8,1038,171,1258,59,63,52,67,61.0,4,59.5,15
2010-04-27 00:00:00,475.612,1969.6,0,80,4745,54,61,52,72,57.5,7,62.0,20
2010-04-27 06:00:00,305.804,1266.2,0,162,438,43,50,82,93,46.5,7,87.5,11
2010-04-27 12:00:00,500.02,2070.8,0,91,4675,43,61,55,93,52.0,18,74.0,38
2010-04-27 18:00:00,256.228,1076.2,0,175,2092,63,68,40,48,65.5,5,44.0,8
2010-04-28 00:00:00,188.888,793.6,0,117,1334,52,66,40,71,59.0,14,55.5,31
2010-04-28 06:00:00,130.508,554.4,0,159,443,45,52,76,93,48.5,7,84.5,17
2010-04-28 12:00:00,258.386,1077.2,0,122,2499,46,70,43,93,58.0,24,68.0,50
2010-04-28 18:00:00,142.81,616.2,0,190,443,72,77,26,43,74.5,5,34.5,17
2010-04-29 00:00:00,336.154,1425.8,0,107,2650,57,77,26,63,67.0,20,44.5,37
2010-04-29 06:00:00,304.342,1259.8,0,201,1186,52,61,59,82,56.5,9,70.5,23
2010-04-29 12:00:00,438.408,1822.2,0,135,4926,55,72,50,77,63.5,17,63.5,27
2010-04-29 18:00:00,146.304,613.4,0,136,491,75,81,32,47,78.0,6,39.5,15
2010-04-30 00:00:00,214.67,907.0,12,207,1499,57,75,41,67,66.0,18,54.0,26
2010-04-30 06:00:00,182.83,773.4,0,185,1256,54,63,59,88,58.5,9,73.5,29
2010-04-30 12:00:00,231.062,961.4,0,113,1264,54,59,72,88,56.5,5,80.0,16
2010-04-30 18:00:00,549.342,2373.4,2688,173,3798,61,63,48,59,62.0,2,53.5,11
2010-05-01 00:00:00,155.394,676.8,7,188,651,52,64,48,67,58.0,12,57.5,19
2010-05-01 06:00:00,160.486,676.8,0,104,988,46,52,71,87,49.0,6,79.0,16
2010-05-01 12:00:00,315.68,1361.4,1020,185,2208,48,61,48,87,54.5,13,67.5,39
2010-05-01 18:00:00,403.536,1738.0,964,2617,812,57,63,52,67,60.0,6,59.5,15
2010-05-02 00:00:00,440.456,1882.8,0,1979,2743,52,59,55,77,55.5,7,66.0,22
2010-05-02 06:00:00,132.95,567.8,0,187,443,50,54,82,94,52.0,4,88.0,12
2010-05-02 12:00:00,449.576,1874.8,0,645,4685,50,55,63,87,52.5,5,75.0,24
2010-05-02 18:00:00,892.346,3774.6,0,4023,6802,52,59,45,76,55.5,7,60.5,31
2010-05-03 00:00:00,713.038,3031.2000000000003,1858,3111,2524,48,55,54,87,51.5,7,70.5,33
2010-05-03 06:00:00,173.878,728.5999999999999,0,182,1117,43,46,81,100,44.5,3,90.5,19
2010-05-03 12:00:00,501.4,2118.6,0,90,5726,43,46,71,87,44.5,3,79.0,16
2010-05-03 18:00:00,165.154,709.4,0,165,980,46,48,66,76,47.0,2,71.0,10
2010-05-04 00:00:00,570.87,2432.2,980,97,4002,45,48,62,87,46.5,3,74.5,25
2010-05-04 06:00:00,121.654,532.4,0,137,303,43,45,71,81,44.0,2,76.0,10
2010-05-04 12:00:00,556.904,2403.0,0,140,5522,43,50,57,76,46.5,7,66.5,19
2010-05-04 18:00:00,405.122,1700.2,0,80,4850,52,52,47,54,52.0,0,50.5,7
2010-05-05 00:00:00,433.28,1848.0,0,661,1332,45,52,47,71,48.5,7,59.0,24
2010-05-05 06:00:00,164.664,695.0,0,76,1087,41,43,76,81,42.0,2,78.5,5
2010-05-05 12:00:00,566.986,2419.2,1066,149,5265,41,52,50,76,46.5,11,63.0,26
2010-05-05 18:00:00,500.416,2135.4,0,1908,4334,52,54,50,51,53.0,2,50.5,1
2010-05-06 00:00:00,573.242,2476.2,1903,61,1497,45,54,47,76,49.5,9,61.5,29
2010-05-06 06:00:00,167.696,715.4,0,77,1087,43,46,76,81,44.5,3,78.5,5
2010-05-06 12:00:00,457.192,1939.4,0,74,5103,43,52,54,81,47.5,9,67.5,27
2010-05-06 18:00:00,271.988,1154.0,0,75,2233,55,59,39,44,57.0,4,41.5,5
2010-05-07 00:00:00,402.374,1695.1999999999998,0,75,1857,48,57,41,66,52.5,9,53.5,25
2010-05-07 06:00:00,165.508,700.6,0,75,1133,41,45,71,87,43.0,4,79.0,16
2010-05-07 12:00:00,572.964,2433.4,1053,75,5932,45,48,71,81,46.5,3,76.0,10
2010-05-07 18:00:00,335.69,1426.4,0,76,3224,52,55,41,67,53.5,3,54.0,26
2010-05-08 00:00:00,569.842,2374.2,0,106,3313,48,55,41,66,51.5,7,53.5,25
2010-05-08 06:00:00,359.228,1483.1999999999998,1077,77,1851,45,48,71,81,46.5,3,76.0,10
2010-05-08 12:00:00,506.946,2168.8,2492,447,3137,45,57,55,81,51.0,12,68.0,26
2010-05-08 18:00:00,340.554,1409.4,0,79,3893,57,63,42,72,60.0,6,57.0,30
2010-05-09 00:00:00,326.694,1397.4,0,1832,1277,48,59,63,94,53.5,11,78.5,31
2010-05-09 06:00:00,144.448,606.2,0,79,426,48,52,87,93,50.0,4,90.0,6
2010-05-09 12:00:00,441.37,1905.0,1109,586,3411,48,57,67,93,52.5,9,80.0,26
2010-05-09 18:00:00,434.478,1841.4,468,98,3817,59,64,48,63,61.5,5,55.5,15
2010-05-10 00:00:00,546.214,2326.8,1311,1873,2291,52,61,55,88,56.5,9,71.5,33
2010-05-10 06:00:00,165.20999999999998,702.6,0,136,914,45,54,72,93,49.5,9,82.5,21
2010-05-10 12:00:00,496.298,2058.0,0,89,5900,46,55,72,93,50.5,9,82.5,21
2010-05-10 18:00:00,207.006,873.2,0,90,1214,55,59,67,77,57.0,4,72.0,10
2010-05-11 00:00:00,599.3779999999999,2500.8,0,88,4865,50,55,67,82,52.5,5,74.5,15
2010-05-11 06:00:00,329.694,1344.4,0,87,3724,45,48,87,87,46.5,3,87.0,0
2010-05-11 12:00:00,596.458,2491.0,1156,86,5493,45,45,87,93,45.0,0,90.0,6
2010-05-11 18:00:00,293.38800000000003,1246.2,0,86,1019,43,45,87,100,44.0,2,93.5,13
2010-05-12 00:00:00,351.828,1461.4,0,86,1182,43,48,87,87,45.5,5,87.0,0
2010-05-12 06:00:00,167.976,697.8,0,84,1128,43,43,81,87,43.0,0,84.0,6
2010-05-12 12:00:00,636.98,2656.0,1036,446,5980,43,48,66,87,45.5,5,76.5,21
2010-05-12 18:00:00,759.872,3153.2,0,3710,6824,48,54,54,71,51.0,6,62.5,17
2010-05-13 00:00:00,470.59,1975.0,0,194,2430,43,48,71,87,45.5,5,79.0,16
2010-05-13 06:00:00,124.486,520.0,0,100,337,43,45,76,81,44.0,2,78.5,5
2010-05-13 12:00:00,356.49,1486.2,503,88,3243,43,48,71,81,45.5,5,76.0,10
2010-05-13 18:00:00,446.422,1830.2,515,88,4304,48,52,58,76,50.0,4,67.0,18
2010-05-14 00:00:00,625.098,2607.4,1105,1201,2643,43,48,76,87,45.5,5,81.5,11
2010-05-14 06:00:00,135.4,574.2,0,84,332,45,46,81,87,45.5,1,84.0,6
2010-05-14 12:00:00,620.7239999999999,2578.8,1045,83,6059,46,50,71,81,48.0,4,76.0,10
2010-05-14 18:00:00,566.848,2352.0,0,84,6869,50,52,62,71,51.0,2,66.5,9
2010-05-15 00:00:00,399.174,1669.0,0,83,3504,46,48,81,93,47.0,2,87.0,12
2010-05-15 06:00:00,176.344,736.0,0,85,1133,43,46,81,93,44.5,3,87.0,12
2010-05-15 12:00:00,497.124,2072.0,1004,83,4714,46,57,38,81,51.5,11,59.5,43
2010-05-15 18:00:00,296.168,1270.4,0,84,2074,57,59,34,39,58.0,2,36.5,5
2010-05-16 00:00:00,975.136,4143.0,2343,84,5749,46,57,38,93,51.5,11,65.5,55
2010-05-16 06:00:00,469.606,1973.6,927,83,2274,39,50,62,93,44.5,11,77.5,31
2010-05-16 12:00:00,306.188,1312.4,0,686,1907,41,59,55,100,50.0,18,77.5,45
2010-05-16 18:00:00,497.762,2110.0,1058,2026,1623,61,64,40,48,62.5,3,44.0,8
2010-05-17 00:00:00,826.87,3466.4,1376,1127,6084,46,59,42,66,52.5,13,54.0,24
2010-05-17 06:00:00,171.192,730.2,0,90,961,50,54,67,82,52.0,4,74.5,15
2010-05-17 12:00:00,525.55,2183.8,0,102,6080,50,57,72,88,53.5,7,80.0,16
2010-05-17 18:00:00,552.572,2283.4,0,90,6638,59,66,42,59,62.5,7,50.5,17
2010-05-18 00:00:00,378.868,1604.0,1014,85,1665,54,64,39,67,59.0,10,53.0,28
2010-05-18 06:00:00,176.456,753.0,0,85,1100,39,50,71,100,44.5,11,85.5,29
2010-05-18 12:00:00,521.7,2179.0,0,84,6049,41,63,45,100,52.0,22,72.5,55
2010-05-18 18:00:00,369.506,1514.2,0,85,2983,63,68,33,42,65.5,5,37.5,9
2010-05-19 00:00:00,353.522,1484.2,0,116,1545,52,61,42,62,56.5,9,52.0,20
2010-05-19 06:00:00,217.27,917.2,0,86,1136,45,52,67,76,48.5,7,71.5,9
2010-05-19 12:00:00,513.544,2128.8,0,284,5149,48,61,29,71,54.5,13,50.0,42
2010-05-19 18:00:00,272.942,1146.4,1059,202,1359,63,66,26,32,64.5,3,29.0,6
2010-05-20 00:00:00,422.996,1821.4,1063,87,2220,55,66,30,58,60.5,11,44.0,28
2010-05-20 06:00:00,143.268,617.2,0,85,448,46,55,54,76,50.5,9,65.0,22
2010-05-20 12:00:00,506.39200000000005,2104.2,0,84,5802,48,64,37,76,56.0,16,56.5,39
2010-05-20 18:00:00,254.136,1068.8,0,86,1989,66,72,35,38,69.0,6,36.5,3
2010-05-21 00:00:00,250.102,1041.4,0,114,1862,55,70,35,68,62.5,15,51.5,33
2010-05-21 06:00:00,186.14,790.8,0,89,1215,54,61,72,82,57.5,7,77.0,10
2010-05-21 12:00:00,541.346,2259.4,1073,85,5348,54,68,46,88,61.0,14,67.0,42
2010-05-21 18:00:00,247.184,1066.8,0,88,1558,70,73,41,46,71.5,3,43.5,5
2010-05-22 00:00:00,319.726,1351.8,0,119,1992,61,72,43,72,66.5,11,57.5,29
2010-05-22 06:00:00,202.276,868.2,0,88,1114,55,61,68,82,58.0,6,75.0,14
2010-05-22 12:00:00,718.062,3027.6000000000004,981,1425,6066,55,70,53,82,62.5,15,67.5,29
2010-05-22 18:00:00,640.642,2710.2,413,823,6043,72,75,31,46,73.5,3,38.5,15
2010-05-23 00:00:00,534.792,2259.4,884,105,4231,63,73,33,63,68.0,10,48.0,30
2010-05-23 06:00:00,207.766,887.2,0,109,1185,54,61,55,88,57.5,7,71.5,33
2010-05-23 12:00:00,380.61,1630.0,864,90,2000,55,73,47,82,64.0,18,64.5,35
2010-05-23 18:00:00,510.766,2169.2,0,123,4328,75,79,32,44,77.0,4,38.0,12
2010-05-24 00:00:00,388.414,1646.8,0,94,2028,63,79,32,52,71.0,16,42.0,20
2010-05-24 06:00:00,160.388,693.0,0,123,544,52,66,60,100,59.0,14,80.0,40
2010-05-24 12:00:00,300.69,1297.8,1000,92,1214,55,79,34,94,67.0,24,64.0,60
2010-05-24 18:00:00,328.598,1401.2,0,1767,1425,81,84,27,32,82.5,3,29.5,5
2010-05-25 00:00:00,551.656,2326.4,875,485,4563,64,84,28,64,74.0,20,46.0,36
2010-05-25 06:00:00,125.554,564.6,0,97,627,55,68,60,100,61.5,13,80.0,40
2010-05-25 12:00:00,503.788,2136.0,0,127,5952,57,79,42,94,68.0,22,68.0,52
2010-05-25 18:00:00,173.558,765.0,0,97,1059,79,84,35,51,81.5,5,43.0,16
2010-05-26 00:00:00,395.726,1705.4,474,130,2801,64,77,47,78,70.5,13,62.5,31
2010-05-26 06:00:00,121.834,589.8,0,118,634,63,64,77,88,63.5,1,82.5,11
2010-05-26 12:00:00,621.236,2644.4,914,399,5769,63,66,68,82,64.5,3,75.0,14
2010-05-26 18:00:00,222.47,986.2,0,1527,548,63,70,64,82,66.5,7,73.0,18
2010-05-27 00:00:00,422.344,1806.0,0,2456,1579,61,66,68,77,63.5,5,72.5,9
2010-05-27 06:00:00,150.512,660.6,0,96,1252,55,55,88,94,55.0,0,91.0,6
2010-05-27 12:00:00,457.882,1930.6,0,127,5308,55,61,88,94,58.0,6,91.0,6
2010-05-27 18:00:00,314.324,1345.4,932,94,2194,59,63,82,94,61.0,4,88.0,12
2010-05-28 00:00:00,400.624,1695.6,0,126,1915,55,61,88,100,58.0,6,94.0,12
2010-05-28 06:00:00,127.848,560.0,0,93,704,52,57,82,94,54.5,5,88.0,12
2010-05-28 12:00:00,510.64,2139.6,0,121,5651,52,63,48,88,57.5,11,68.0,40
2010-05-28 18:00:00,402.436,1699.0,0,91,3907,63,68,33,45,65.5,5,39.0,12
2010-05-29 00:00:00,357.24,1504.0,1020,108,1354,57,66,32,94,61.5,9,63.0,62
2010-05-29 06:00:00,134.556,599.8,0,104,449,50,57,63,87,53.5,7,75.0,24
2010-05-29 12:00:00,534.152,2268.6,810,89,5207,50,63,59,87,56.5,13,73.0,28
2010-05-29 18:00:00,538.394,2275.2,1609,119,4453,59,64,48,82,61.5,5,65.0,34
2010-05-30 00:00:00,842.706,3554.8,1638,88,6526,57,59,63,94,58.0,2,78.5,31
2010-05-30 06:00:00,253.01,1061.8,518,90,441,55,59,88,100,57.0,4,94.0,12
2010-05-30 12:00:00,372.798,1582.4,449,403,2524,55,61,72,88,58.0,6,80.0,16
2010-05-30 18:00:00,436.012,1876.4,1438,1259,2151,59,63,68,77,61.0,4,72.5,9
2010-05-31 00:00:00,603.88,2538.4,0,1224,4592,57,59,77,94,58.0,2,85.5,17
2010-05-31 06:00:00,99.63,453.8,0,90,404,54,55,72,82,54.5,1,77.0,10
2010-05-31 12:00:00,539.6659999999999,2261.8,0,534,6496,55,61,59,63,58.0,6,61.0,4
2010-05-31 18:00:00,296.47,1267.4,484,1457,1562,61,63,55,63,62.0,2,59.0,8
2010-06-01 00:00:00,404.696,1738.2,1226,90,1999,55,61,63,82,58.0,6,72.5,19
2010-06-01 06:00:00,102.478,461.6,0,117,380,46,50,87,100,48.0,4,93.5,13
2010-06-01 12:00:00,530.798,2228.6,970,87,5896,50,59,72,100,54.5,9,86.0,28
2010-06-01 18:00:00,447.222,1869.8,0,87,5200,61,63,68,77,62.0,2,72.5,9
2010-06-02 00:00:00,188.466,794.2,0,109,382,54,59,82,88,56.5,5,85.0,6
2010-06-02 06:00:00,178.246,761.4,0,94,1348,54,55,94,100,54.5,1,97.0,6
2010-06-02 12:00:00,415.52,1740.6,0,327,4660,54,61,82,94,57.5,7,88.0,12
2010-06-02 18:00:00,168.022,756.0,0,106,1125,64,70,43,64,67.0,6,53.5,21
2010-06-03 00:00:00,219.11,940.8,0,129,1321,57,70,43,94,63.5,13,68.5,51
2010-06-03 06:00:00,157.046,685.2,0,139,1128,54,57,67,77,55.5,3,72.0,10
2010-06-03 12:00:00,568.3820000000001,2379.0,1038,97,6151,55,70,53,72,62.5,15,62.5,19
2010-06-03 18:00:00,454.592,1944.6,997,96,4573,72,75,44,50,73.5,3,47.0,6
2010-06-04 00:00:00,214.166,973.2,881,119,452,61,75,44,68,68.0,14,56.0,24
2010-06-04 06:00:00,169.974,737.6,0,106,1437,57,63,63,77,60.0,6,70.0,14
2010-06-04 12:00:00,528.314,2210.6,972,96,5927,61,77,41,68,69.0,16,54.5,27
2010-06-04 18:00:00,376.408,1604.4,88,96,3991,79,81,34,42,80.0,2,38.0,8
2010-06-05 00:00:00,345.858,1500.2,635,99,1162,64,81,39,68,72.5,17,53.5,29
2010-06-05 06:00:00,253.578,1121.0,888,102,1438,57,63,82,94,60.0,6,88.0,12
2010-06-05 12:00:00,477.52,2061.4,961,471,4526,59,79,42,100,69.0,20,71.0,58
2010-06-05 18:00:00,530.266,2383.6,3670,420,2464,81,82,35,42,81.5,1,38.5,7
2010-06-06 00:00:00,748.28,3211.0,5413,260,3795,64,82,39,77,73.0,18,58.0,38
2010-06-06 06:00:00,347.836,1585.0,2932,166,969,64,70,64,83,67.0,6,73.5,19
2010-06-06 12:00:00,218.158,965.4,844,127,1083,64,68,78,94,66.0,4,86.0,16
2010-06-06 18:00:00,766.986,3297.2,3825,119,6672,68,72,64,83,70.0,4,73.5,19
2010-06-07 00:00:00,413.812,1767.4,8,162,2641,63,72,56,64,67.5,9,60.0,8
2010-06-07 06:00:00,114.914,519.8,0,129,476,52,57,82,94,54.5,5,88.0,12
2010-06-07 12:00:00,441.854,1863.2,914,121,4515,54,68,52,94,61.0,14,73.0,42
2010-06-07 18:00:00,170.89600000000002,744.5999999999999,0,118,1215,70,73,41,56,71.5,3,48.5,15
2010-06-08 00:00:00,284.418,1239.8,907,120,531,59,73,44,77,66.0,14,60.5,33
2010-06-08 06:00:00,160.868,701.4,0,118,1311,61,63,72,77,62.0,2,74.5,5
2010-06-08 12:00:00,566.512,2398.8,944,118,5803,61,68,60,82,64.5,7,71.0,22
2010-06-08 18:00:00,284.764,1197.2,0,118,2640,66,72,53,68,69.0,6,60.5,15
2010-06-09 00:00:00,349.89,1511.2,569,467,1620,63,68,68,77,65.5,5,72.5,9
2010-06-09 06:00:00,125.362,558.0,0,122,540,59,64,77,94,61.5,5,85.5,17
2010-06-09 12:00:00,535.304,2283.4,1010,121,5471,59,64,83,100,61.5,5,91.5,17
2010-06-09 18:00:00,391.83,1662.2,937,2822,460,63,64,83,94,63.5,1,88.5,11
2010-06-10 00:00:00,482.186,2040.8,827,1204,1784,61,64,77,100,62.5,3,88.5,23
2010-06-10 06:00:00,168.264,751.6,0,119,1243,61,61,94,100,61.0,0,97.0,6
2010-06-10 12:00:00,479.936,2012.4,0,117,5539,61,66,94,100,63.5,5,97.0,6
2010-06-10 18:00:00,243.32,1045.0,0,118,2372,68,75,65,88,71.5,7,76.5,23
2010-06-11 00:00:00,323.67,1362.8,0,120,1716,61,70,83,100,65.5,9,91.5,17
2010-06-11 06:00:00,115.268,517.2,0,118,470,59,63,94,100,61.0,4,97.0,6
2010-06-11 12:00:00,612.128,2542.4,950,115,6951,59,72,60,94,65.5,13,77.0,34
2010-06-11 18:00:00,370.522,1638.4,727,116,3050,75,79,44,57,77.0,4,50.5,13
2010-06-12 00:00:00,372.754,1656.0,1762,119,1257,63,79,39,94,71.0,16,66.5,55
2010-06-12 06:00:00,191.102,839.0,504,116,1153,61,63,94,100,62.0,2,97.0,6
2010-06-12 12:00:00,460.474,1954.8,363,118,4918,59,61,88,100,60.0,2,94.0,12
2010-06-12 18:00:00,586.346,2529.2,1838,1380,3978,63,68,60,82,65.5,5,71.0,22
2010-06-13 00:00:00,735.186,3091.8,0,2043,6135,63,68,60,88,65.5,5,74.0,28
2010-06-13 06:00:00,226.398,986.0,0,249,1181,52,59,77,82,55.5,7,79.5,5
2010-06-13 12:00:00,451.848,2001.8,2893,146,2163,54,64,59,82,59.0,10,70.5,23
2010-06-13 18:00:00,443.93,1939.6,1084,411,3147,64,68,52,59,66.0,4,55.5,7
2010-06-14 00:00:00,552.1800000000001,2359.0,945,1710,2605,57,68,52,77,62.5,11,64.5,25
2010-06-14 06:00:00,167.986,769.0,0,128,952,55,59,72,88,57.0,4,80.0,16
2010-06-14 12:00:00,461.232,1935.6,0,114,5921,55,66,68,88,60.5,11,78.0,20
2010-06-14 18:00:00,253.34,1081.0,0,109,2110,63,68,56,77,65.5,5,66.5,21
2010-06-15 00:00:00,335.426,1418.2,958,122,1353,59,64,68,77,61.5,5,72.5,9
2010-06-15 06:00:00,161.188,701.0,0,104,1279,57,59,82,94,58.0,2,88.0,12
2010-06-15 12:00:00,372.812,1605.8,0,132,3884,57,66,68,88,61.5,9,78.0,20
2010-06-15 18:00:00,323.57,1369.6,0,124,3773,66,70,56,68,68.0,4,62.0,12
2010-06-16 00:00:00,366.396,1540.6,0,128,1208,59,68,56,82,63.5,9,69.0,26
2010-06-16 06:00:00,329.146,1367.4,0,114,1065,52,55,67,76,53.5,3,71.5,9
2010-06-16 12:00:00,497.51,2100.2,965,112,4972,52,63,59,76,57.5,11,67.5,17
2010-06-16 18:00:00,496.382,2105.8,0,3620,2965,66,70,46,56,68.0,4,51.0,10
2010-06-17 00:00:00,445.054,1891.2,910,1153,1334,59,70,46,63,64.5,11,54.5,17
2010-06-17 06:00:00,122.442,559.6,0,130,492,59,64,56,72,61.5,5,64.0,16
2010-06-17 12:00:00,345.324,1471.0,0,121,3894,59,61,63,77,60.0,2,70.0,14
2010-06-17 18:00:00,277.22,1175.6,0,119,2818,61,68,56,77,64.5,7,66.5,21
2010-06-18 00:00:00,283.032,1187.2,0,118,1306,61,66,56,72,63.5,5,64.0,16
2010-06-18 06:00:00,150.492,661.4,0,114,1129,57,66,56,82,61.5,9,69.0,26
2010-06-18 12:00:00,525.71,2232.2,977,112,5409,57,63,72,88,60.0,6,80.0,16
2010-06-18 18:00:00,339.622,1451.6,0,113,3675,66,68,64,64,67.0,2,64.0,0
2010-06-19 00:00:00,316.492,1337.0,0,115,1764,61,66,56,72,63.5,5,64.0,16
2010-06-19 06:00:00,176.74,764.4,0,113,1072,52,57,59,88,54.5,5,73.5,29
2010-06-19 12:00:00,419.106,1770.6,852,107,4099,52,59,51,88,55.5,7,69.5,37
2010-06-19 18:00:00,383.52,1660.2,599,289,3068,57,61,45,55,59.0,4,50.0,10
2010-06-20 00:00:00,436.854,1873.2,934,1294,1315,52,59,67,82,55.5,7,74.5,15
2010-06-20 06:00:00,128.894,576.0,0,166,664,50,50,76,76,50.0,0,76.0,0
2010-06-20 12:00:00,336.82,1429.2,0,110,3597,50,57,63,76,53.5,7,69.5,13
2010-06-20 18:00:00,455.176,1921.2,0,541,4767,55,59,55,67,57.0,4,61.0,12
2010-06-21 00:00:00,751.6600000000001,3164.8,1021,3378,3309,52,59,55,71,55.5,7,63.0,16
2010-06-21 06:00:00,151.148,647.8,0,108,1096,48,52,71,82,50.0,4,76.5,11
2010-06-21 12:00:00,413.556,1735.2,0,106,5024,52,59,59,76,55.5,7,67.5,17
2010-06-21 18:00:00,454.818,2007.6,1241,2385,2026,59,64,49,59,61.5,5,54.0,10
2010-06-22 00:00:00,641.3679999999999,2734.0,2583,926,3033,54,63,55,72,58.5,9,63.5,17
2010-06-22 06:00:00,102.846,509.0,0,117,402,50,54,88,94,52.0,4,91.0,6
2010-06-22 12:00:00,555.03,2370.0,0,1326,5724,55,66,40,88,60.5,11,64.0,48
2010-06-22 18:00:00,360.17,1578.1999999999998,0,2812,1202,68,73,35,41,70.5,5,38.0,6
2010-06-23 00:00:00,502.542,2140.4,968,1921,1902,64,72,43,59,68.0,8,51.0,16
2010-06-23 06:00:00,100.884,456.0,0,85,470,52,57,77,94,54.5,5,85.5,17
2010-06-23 12:00:00,508.022,2181.6,784,317,5824,57,73,44,88,65.0,16,66.0,44
2010-06-23 18:00:00,189.53,850.4000000000001,11,522,1475,73,77,36,44,75.0,4,40.0,8
2010-06-24 00:00:00,643.628,2823.8,4945,576,2419,63,77,38,64,70.0,14,51.0,26
2010-06-24 06:00:00,163.36,722.8,0,156,1156,55,64,67,82,59.5,9,74.5,15
2010-06-24 12:00:00,372.14,1567.2,0,421,4027,59,75,41,82,67.0,16,61.5,41
2010-06-24 18:00:00,131.866,603.0,0,149,525,77,82,32,42,79.5,5,37.0,10
2010-06-25 00:00:00,428.414,1822.4,973,157,2382,61,81,34,72,71.0,20,53.0,38
2010-06-25 06:00:00,111.024,507.0,0,178,544,59,66,64,77,62.5,7,70.5,13
2010-06-25 12:00:00,491.038,2081.0,0,174,5956,59,77,44,82,68.0,18,63.0,38
2010-06-25 18:00:00,250.45,1123.4,0,197,2215,77,82,28,44,79.5,5,36.0,16
2010-06-26 00:00:00,246.926,1071.0,0,140,1751,68,82,30,64,75.0,14,47.0,34
2010-06-26 06:00:00,148.988,662.4,0,161,1189,61,68,60,82,64.5,7,71.0,22
2010-06-26 12:00:00,292.094,1306.6,722,668,1638,63,79,44,82,71.0,16,63.0,38
2010-06-26 18:00:00,341.372,1477.6,199,168,3484,82,84,33,35,83.0,2,34.0,2
2010-06-27 00:00:00,199.166,877.2,0,224,1628,70,82,37,53,76.0,12,45.0,16
2010-06-27 06:00:00,161.538,729.2,0,146,1179,63,72,60,82,67.5,9,71.0,22
2010-06-27 12:00:00,255.31,1134.4,962,226,1314,66,84,37,73,75.0,18,55.0,36
2010-06-27 18:00:00,396.362,1710.6,824,140,3501,84,88,29,33,86.0,4,31.0,4
2010-06-28 00:00:00,326.754,1444.6,879,252,1696,72,84,35,57,78.0,12,46.0,22
2010-06-28 06:00:00,145.238,667.4,0,143,661,68,73,57,73,70.5,5,65.0,16
2010-06-28 12:00:00,379.726,1636.0,0,268,4389,70,82,42,73,76.0,12,57.5,31
2010-06-28 18:00:00,399.004,1691.2,0,200,3824,82,86,33,42,84.0,4,37.5,9
2010-06-29 00:00:00,547.372,2301.8,0,198,3642,66,75,53,88,70.5,9,70.5,35
2010-06-29 06:00:00,187.466,835.8,0,271,711,63,72,60,94,67.5,9,77.0,34
2010-06-29 12:00:00,463.852,1978.2,898,162,4344,64,75,41,88,69.5,11,64.5,47
2010-06-29 18:00:00,282.044,1270.8,0,260,1899,77,84,25,41,80.5,7,33.0,16
2010-06-30 00:00:00,433.934,1903.8,848,1285,1309,72,82,25,73,77.0,10,49.0,48
2010-06-30 06:00:00,181.604,794.0,0,214,1226,57,68,46,82,62.5,11,64.0,36
2010-06-30 12:00:00,249.524,1076.6,0,151,2130,57,79,36,88,68.0,22,62.0,52
2010-06-30 18:00:00,419.444,1793.4,0,290,1237,81,86,25,32,83.5,5,28.5,7
2010-07-01 00:00:00,533.564,2231.0,398,151,621,70,88,27,47,79.0,18,37.0,20
